#English-Spanish FreeDict Dictionary
zucchini	calabacín
ABC	abecé, alfabeto
Adam	Adán
Africa	África
African	africano; africano
African	africana
Aix	Aquisgrán
Alexander	Alejandro
Algerian	argelino; argelino
Algerian	argelina
Algiers	Argel
All	TodoslosSantos
All	TodoslosSantos
All	TodoslosSantos, eldíadeTodoslosSantos
Alpine	refugio
Alps	Alpes
Amazon	ríoAmazonas; amazona
America	América
American	americano; americano; americano; americano
American	amerindio, indioamericano
American	ñandu
American	americana
Amsterdam	Amsterdam
Andalusia	Andalucía
Andorra	Andorra
Annunciation	Anunciación
Antilles	Antillas
Antwerp	Amberes
Apocalypse	Apocalipsis
April	abril
Arab	árabe
Arabia	Arabia
Arabian	árabe
Arabic	árabe
Argentina	Argentina
Argentine	argentino; argentino
Argentinean	argentino
Argentinian	argentina
Arizona	Arizona
Aruba	Aruba
Ascension	Ascensión
Asia	Asia
Asian	asiático; asiático
Asiatic	asiático
Asia	AsiaMenor
Asturias	Asturias
Athena	Atenas
Athene	Atenas
Athens	Atenas
Atlantic	atlántico
August	agosto
Australia	Australia
Australian	australiano
Austria	Austria
Austrian	austriaco; austriaco
Aztec	azteca
Balearic	IslasBaleares
Balkans	Balkanes
Baltic	báltico
Baltic	Báltico, marBáltico
Basque	vasco, vascuence; vasco, vascuence; vasco
Basque	PaísVasco
Basque	vasco, vascuence
Bay	MarCantábrico
Belgian	belga; belga; belga
Belgian	belga
Belgium	Bélgica
Bengal	Bengala
Berlin	Berlín
Bible	Biblia
Biscay	Vizcaya; Vizcaya
Bolivia	Bolivia
Bordeaux	Burdeos
Brazil	Brasil
Brazilian	brasileño; brasileño
Brazilian	brasileña
Britain	GranBretaña
British	británico
Briton	britano
Brussels	colesdeBruselas
Brussels	Bruselas
Bulgar	búlgaro
Bulgaria	Bulgaria
Bulgarian	búlgaro; búlgaro
Bulgarian	búlgara
Canada	Canadá
Canary	canario
Canary	IslasCanarias
Candlemas	Candelaria, Purificación
Cantabrian	cantábrico
Castile	Castilla
Castillian	castellano
Catalonia	Cataluña
Catalonian	catalán
Catholic	católico
Caucasus	Cáucaso
Chile	Chile
Chilean	chileno; chileno
Chilean	chilena
China	China
Chinaman	chino
Chinese	chino; chino
Christ	Cristo
Christian	cristiano; cristiano
Christianity	cristianismo
Christmas	Navidad
Cinderella	Cenicienta
Cologne	Colonia
Colombia	Colombia
Columbus	Colón; Colón; Colón
Cordova	Córdoba
Corpus	díadelCorpus
Corsica	Córcega
Costa	CostaBrava
Costa	CostaRica
Crete	Creta
Cuba	Cuba
Cuban	cubano
Cura	Curazao
Czech	checo; checo
Czechoslovakia	Checoeslovaquia
Dane	danés, dinamarqués
Danish	danés, dinamarqués
December	diciembre
Denmark	Dinamarca
Dutch	holandés; holandés, neerlandés; neerlandés
Dutchman	holandés; holandés, neerlandés
Dutch	neerlandés
Dutch	neerlandesa
East	este
Easter	Pascua
Ecuador	Ecuador
Egypt	Egipto
Egyptian	egipcíaco, egipcio; egipcíaco, egipcio
El	ElSalvador
England	Inglaterra; Inglaterra
English	inglés; inglés; inglesa
Englishman	inglés
Englishwoman	inglesa
English	inglés
Equatorial	GuineaEcuatorial
Eskimo	esquimal
Esperanto	esperanto
Estonia	Estonia
Estremadura	Extremadura
Etna	Etna
Europa	Europa; Europa
Europe	Europa
European	europeo; europeo
European	UnionEuropea
Falklands	IslasMalvinas
Falkland	IslasMalvinas
Far	ExtremoOriente; ExtremoOriente
Feast	Cenopegias, FiestadelosTabernáculos
February	febrero
Finland	Finlandia
Finn	finés, finlandés
Finnish	finés, finlandés; finés, finlandés; finesa, finlandesa
Finnish	finés, finlandés
Finnish	finesa, finlandesa
Flanders	Flandes
Flemming	flamenco
Flemmish	flamenco
France	Francia
French	francés; francés
Frenchman	francés
Frenchwoman	francesa
French	francés
Friday	viernes
Friesland	Frisia
Frisian	frisio, frisón; frisio, frisón; frisio, frisón; frisona; frisio, frisón
Frisian	frisona
Galicia	Galicia
Galician	gallego
Geneva	Ginebra
Genoa	Génova
German	alemán; alemán; alemana; alemán
Germany	Alemania
German	alemán
German	alemana
Ghent	Gante
Gibraltar	Gibraltar
God	Dios
God	camposanto, cementerio
Good	ViernesSanto
Goth	godo
Gothic	gótico
Great	GranBretaña
Greece	Grecia
Greek	griego; grieco; griego
Greek	griega
Greenland	Groenlandia; Groenlandia
Guatemala	Guatemala
Guatemala	Guatemala
Guelderland	Güeldres
Guelders	Güeldres
Havana	Havana
Hebrew	hebraico, hebreo; hebraico, hebreo
Hindu	hindú
Holland	Holanda; Holanda, LosPaísesBajos
Hollander	holandés
Honduras	Honduras
Hungarian	húngaro; húngara; húngaro
Hungarian	húngara
Hungary	Hungría
Iberian	ibérico
Iceland	Islandia
India	India
Indian	indico, indio; indio; indio; amerindio, indioamericano
Indian	maíz
Indonesia	Indonesia
Indonesian	indonésico, indonesio
Ireland	Irlanda
Irish	irlandés
Irishman	irlandés
Israeli	israelí
Israelian	israelí
Israelite	hebreo, israelita, judío
Italian	italiano; italiano; italiano
Italian	italiano
Italian	italiana
Italy	Italia
January	enero
Japan	Japón
Japanese	japonés; japonés; japonés
Japanese	japonés
Japanese	japonesa
Java	Java
Javan	javanés
Javanese	javanés; javanés
Javanese	javanesa
Jesus	Jesucristo
Jew	hebraico, hebreo
Jewish	hebraico, hebreo
July	julio
June	junio
Koran	Alcorán
Lady	Anunciación
Lake	lagoLemán
Lapland	Laponia
Latin	latino; latín
Latvia	Latvia, Letonia
Latvian	letón
Lett	letón
Lisbon	Lisboa
Lithuania	Lituania
Little	Blanca?Nieve
Livonia	Livonia
Li	Lieja
London	Londres
Londoner	londinense
Lorraine	Lorena
Lothringen	Lorena
Louvain	Lovaina
Lucifer	Satán, Satanás
Luxemburg	Luxemburgo; Luxemburgo; luxemburgués
Luxemburger	luxemburgués; luxemburgués
Madrid	Madrid
Majorca	Mallorca
Malay	malayo; malayo
Malines	Malinas
March	marzo
Marseilles	Marsella
Mauretanian	morisco, moro; moro
May	mayo
Mechlin	Malinas
Mediterranean	Mediterráneo
Meuse	Mosa
Mexican	mejikano; mejicano
Mexican	mejicana
Mexico	Méjico, México
Mexico	México
Middle	edadmedia
Mister	caballero, señor
Mohammed	Mahoma
Monday	lunes
Moor	moro
Moorish	morisco, moro
Moresque	morisco, moro
Moroccan	marroquí, marroquín; marroquí, marroquín
Moroccan	marroquía, marroquína
Morocco	Marruecos
Moscow	Moscú
Moselle	Mosela
Moses	Moisés
Mr	caballero, señor
Mrs	señorita
Muhammad	Mahoma
Munich	Munich
Naples	Nápoles
Negro	negro
New	NuevaYork
New	NuevaGalesdelSur
New	añonuevo
New	NuevaYork
New	NuevaYork
Nicaragua	Nicaragua
Nile	Nilo
Nimwegen	Nimega
Noah	Noé
North	norte
North	Américaseptentrional, Norteamérica
North	Holandaseptentrional
North	mardelNorte
Norway	Noruega
Norwegian	noruego; noruego
Norwegian	noruega
November	noviembre
Oceania	Oceanía
Oceanica	Oceanía
October	octubre
Our	NuestraSeñora; NuestraSeñora
Pacific	Pacífico, OcéanoPacífico
Pacific	Pacífico, OcéanoPacífico
Palm	domingadeRamos
Panama	Panamá
Paraguay	Paraguay
Paris	París
Parisian	parisiense
Parthian	parte; parte
Patagonia	Patagonia
Pentecost	Pentecostés
Persia	Persia
Persian	persa; persa
Peru	Perú
Peruvian	peruano; peruano
Peruvian	peruana
Philippines	islasFilipinas
Philippine	islasFilipinas
Poland	Polonia
Pole	polaco, polonés
Polish	polaco, polonés
Polish	polaca, polonesa
Portugal	Portugal
Portuguese	portugués; portugués; portugués
Portuguese	portugués
Portuguese	portuguesa
Protestant	protestante
Prussia	Prusia
Prussian	prusiano; prusiano
Pyrenean	pirenaico
Pyrenees	Pirineos
Redeemer	Redentor, Salvador; Redentor, Salvador
Red	CruzRoja
Red	indio
Red	marRojo
Rhine	Rin
Rio	RioBrava, RioGrandedelNorte
Roman	romano; romano; romano; romano
Romanesque	románico
Romania	Rumania; Rumania
Romanian	rumano; rumano
Rome	Roma
Rumanian	rumano
Russia	Rusia
Russian	ruso; ruso
Russian	rusa
Sahara	Sahara
Sardina	Cerdeña
Sardinia	Cerdeña; Cerdeña; Cerdeña
Sassenach	inglés
Satan	Satán, Satanás
Saviour	Redentor, Salvador; Redentor, Salvador; Redentor, Salvador
Saxe	Sajonia; Sajonia
Saxon	sajón; sajón
Saxony	Sajonia; Sajonia
Scandinavia	Escandinavia; Escandinavia
Scheldt	Escalda
Scot	escocés
Scotland	Escocia
Scotsman	escocés
Scottish	escocés
September	septiembre
Seville	Sevilla
Shrove	martesdecarnestolendas
Siberia	Siberia
Siberian	siberiana; siberiano
Slav	eslavo
Slavic	eslavo
South	ÁfricadelSur
South	sudafricano
South	AméricadelSur, Américameridional
South	sudamericano
Soviet	Uniónsoviética
Spain	España
Spaniard	español
Spanish	español; español
Spanish	español
Spanish	española
Strait	EstrechodeGibraltar
Strasbourg	Estrasburgo
Sunday	domingo
Surinam	Surinam
Swede	sueco
Sweden	Suecia
Swedish	sueco
Swiss	suizo; suizo
Switzerland	Suiza
TV	televisión
Tagus	Tajo
Thames	Támesis
The	LaHaya
Thursday	jueves
Trinity	Trinidad
Tuesday	martes
Tunis	Túnez
Turk	turco
Turkey	Turquía
Turkish	turco
Turkish	turca
Turkish	turca
USA	EstadosUnidos
USSR	Uniónsoviética
US	americano
United	EstadosUnidos
Uruguay	Uruguay
VAT	IVA
Valencia	Valencia; Valencia
Venezuela	Venezuela
Vienna	Viena
Vistula	Vístula
Wales	Gales
Wednesday	miércoles
West	oeste
Western	Europaoccidental
Whitsunday	Pentecostés
X	rayosdeRöntgen, rayosx
X	equis
Yugoslavia	Yugoeslavia
Yule	Navidad
Zealand	Zelandia; zelandés
Zealander	zelandés; %h...ago; hace...
a	a, dentrode, en, por; alguien, alguno, cierto; por; un, una
abandon	abandonar
abandonment	cesión
abate	calmarse, sosegarse; amainar; disminuir; amainar, decrecer, disminuir, menguar
abatement	baja; descuento, rebaja, reducción
abbess	abadesa
abbey	abadía
abbot	abad; abad
abbreviate	abreviar, acortar
abbreviation	abreviación, abreviatura
abdicate	abdicar
abdomen	vientre
aberrance	desvío
aberration	desvío; equivocación, error, yerro
abet	instigar; sostener
abhor	detestar
abhorrence	aversión, horror; horror
abhorrent	abominable, horrible, horroroso
abide	esperar; aguardar, esperar
abiding	continuo
ability	capacidad, habilidad; poder, virtud; capacidad, disposición
abject	menesteroso, miserable, necesitado, pobre
abjure	abjurar; anular, contramandar
able	capaz, hábil
abnormal	anormal, irregular; anormal, irregular; anormal, irregular; anormal, irregular
aboard	abordo
abode	domicilio; domicilio
abolish	abolir, abrogar; anular, contramandar
abolition	abolición; abolición; abolición
abominable	abominable, horrible, horroroso
abominate	detestar
abomination	aversión, horror
aboriginal	indígena; indígena; original
abort	provocarunaborto
abortion	aborto
about	encuantoa, porlotocantea, respectode; encuantoa, porlotocantea, respectode; aesode, apróximadamente, cercade; alrededorde, entornode
above	honrado, sincero; sincero
above	alnortede; encimade; arriba
above	sobretodo; sobretodo, principalmente
abreact	descargar
abridge	limitar; abreviar, acortar
abridgement	resumen
abroad	enelextranjero; fuera
abrogate	abolir, abrogar; anular, contramandar
abrogation	abolición; abolición
abrupt	bronco, brusco; escarpado
abscess	absceso
absence	ausencia; falta
absent	distraído
absent	ausente; ausente; ausente
absent	quitarse, salir
absolute	absoluto; absoluto; absoluto; absoluto; cabal, completo
absolutely	enefecto; deveras, enefecto, enrealidad, verdaderamente
absolute	autócrata
abstract	decudir; arrancar, descolgar, quitar; decudir; resumen
abstracted	distraído
abstraction	robo
abundance	riqueza
abuse	injuriar; injuria, insulto, ofensa; insultar, ofender, ultrajar; injuria, ofensa
abyss	abismo, despeñadero, precipicio
academic	estudiante
academy	academia
academy	conservatorio
accede	acordar, declarar
accelerator	acelerador; acelerador
accelerator	acelerador; acelerador
accent	acentuar; acento; acento, dejo
accentuate	acentuar
accent	acento
accept	aceptar, admitir, tomar
acceptable	aceptable, admisible; aceptable, admisible, razonable
acceptance	aceptación
access	acometida, agresión, ataque; entrada; instinto
accessible	alcanzable
accession	adquisición, ganancia; adquisición, compra, ganancia; presentación
accessory	apéndice
accidence	acaso
accident	accidente, desgracia
acclaim	aplaudir; aplauso
acclamation	aplauso
acclivity	cuesta
accommodating	oficioso, servicial
accommodation	acuerdo, arreglo, construcción; acuerdo, arreglo, convenio; compromiso; alojamiento
accomodate	acomodar, adaptar; servir; acabar, concluir, terminar; ayudar
accompaniment	acompañamiento
accompany	acompañar
accomplish	alcanzar; realizar; cometer, hacer, perpetrar
accomplished	dotado, talentoso
accomplishment	acción
accord	acorde, acuerdo, concordación, convenio; acuerdo, arreglo, convenio; permitir
accordance	acorde, acuerdo, concordación, convenio
accordion	acordeón
accost	dirigirlapalabraa, dirigirsea
account	explicación; cuenta; información; cuenta; explicación; communicación, noticia; considerar, contemplar, tomarenconsideración; cuenta; creer; 10.lugar, motivo; 11.descripción
accountable	responsable; responsable
accountant	contadorpúblico, peritodecontabilidad
account	registro
account	desarrollar, explicar; desarrollar, explicar
accredit	creer
accretion	aumento, incremento
accrue	descender; aumentar, crecer; aumentar
accumulator	acumulador
accurate	preciso; escrupuloso, meticuloso
accusal	acusación, cargo; acusación, cargo
accusation	acusación, cargo; acusación, cargo, denuncia; acusación, cargo
accuse	acusar, denunciar; acusar, delatar, denunciar; acusar, denunciar
accused	acusado; acusado
accustom	acostumbrarse, habituarse
ace	as
acerbic	afilado, agudo; amargo
acetous	agrio
ache	desear; doler; dolor
achieve	alcanzar, consequir, obtener, procurarse; alcanzar; realizar; cometer, fabricar, hacer, perpetrar; cometer, hacer, perpetrar
achievement	acción; acción
acid	agrio; agrio
acknowledge	confesar, declarar; confirmar
acknowledgement	confesión, declaración; recibo, talón
acolyte	partidario; partidario
acquaint	informar; informar, divulgar, publicar
acquaintance	notoriedad; conocido; conocimiento
acquiescence	resignación
acquire	alcanzar, consequir, obtener, procurarse; comprar, procurarse
acquisition	adquisición, ganancia; adquisición, compra, ganancia; compra; adquisición, compra; adquisición, compra
acquisitive	ávido, codicioso
across	atravésde
across	contra
act	acción; acta, certificado; acta, certificado; cometer, fabricar, hacer, perpetrar; acción; influiren
action	acción; acción; batalla; acción; proceso
activate	causar, instigar, maquinar, ocasionar, producir
active	activo; activo; activo; activo; activo, laborioso
activity	acción
actor	actor
actress	actriz
actually	enefecto
act	representar
act	amnistía
act	realizar
acuity	atención
acute	agudo, fulminante; violento
ad	anuncio
adapt	acomodar, adaptar; acomodar, adaptar
add	sumar
adder	áspid, víbora
addition	apéndice
additional	extra
addled	podrido; zote
address	dirigir; dirección, señas; dirigirlapalabraa, dirigirsea
address	directorio
add	sumar; sumar
adept	partidario
adherence	afectuosidad; afectuosidad
adherent	partidario
adherents	partido; partido; partido
adhere	serpartidariode
adhesive	parche
adhesive	cintapegante
adieu	adiós
adjacent	adyacente, contiguo, vecino; adyacente, contiguo, vecino; adyacente, contiguo, vecino
adjective	adjetivo
adjoining	adyacente, contiguo, vecino
adjournment	retraso
adjunct	apéndice
adjust	acomodar, adaptar; ajustar
adjustable	llave
adjustment	acuerdo, arreglo, construcción
adjutant	ayudante, edecán
administer	administrar; administrar; administrar
administer	viaticar
administration	administración; administración; administración; gobierno
administration	administracióndelSacramento
administrator	administrador, gerente
admiral	almirante
admire	admirar
admission	aceptación; entrada; preciodeentrada; confesión, declaración
admission	preciodeentrada
admission	billetedeentrada
admit	confesar, declarar; permitir
admittance	entrada
admixture	mezcla
admonish	exhortar, requerir
admonition	exhortación
ado	ruido
adopt	adoptar, prohijar; adoptar, prohijar
adopted	adoptivo
adoration	adoración
adore	adorar
adorn	decorar
adorned	adornado
adornment	alhaja; alhaja
adroit	ágil, experto, diestro, hábil
adstringent	astrigenteantidiárrico; astrigenteantidiárrico; astrigenteantidiárrico
advance	acercarse, aproximarse
advancement	progreso
advantage	ventaja; provecho, ventaja
advantageous	favorable
adventure	aventura
adventurer	aventurero
adventurous	aventurero; aventurero; arriesgado
adverb	adverbio
adversary	enemigo
advert	atender, atendera, tenercuidado
advertence	atención
advertency	atención
advertise	anunciar, publicar
advertisement	anuncio
advice	consejo; noticia, noticias, publicación
advise	anunciar; aconsejar
advise	desaconsejar
advocate	abogado
aerate	ventilar
aerial	antena
aerodrome	aeropuerto
aerogramme	cartaaérea
aeronautics	aviación
aeroplane	aeroplano, avión
afar	lejos
affable	amable, bonito, gracioso
affair	asunto, particular; caso
affect	afectar; influiren; conmover
affectation	afectación; afectación
affecting	conmovedor; conmovedor
affection	amor; afectuosidad
affectionate	mimoso, zalamero; afectuoso
affiliate	adaptar, prohijar
affirm	asegurar; asentir, confirmar
affirmation	promesa
affix	fijar
afflict	afligir, entristecer; afligir, entristecer
affluence	riqueza
afford	permitir; producir
afraid	medroso, miedo, miedoso, temeroso; medroso, miedo, miedoso, temeroso; encogido, tímido, miedo; angustioso, medroso
afresh	denuevo, otravez; denuevo, otravez
after	detrásde, tras; después
afternoon	tarde
afterwards	después, luego, másadelante
again	denuevo, otravez; denuevo, otravez
against	contra
agate	ágata
age	edad
agency	agencia
agenda	agenda, dietario; ordendeldía
agent	agente, representante; herramienta, instrumento, medio
aggrandizement	ampliación
aggravating	escandaloso
aggression	acometida, agresión, ataque
aggressor	agresor, atacador
agitate	conmover; preocupar
agitated	inquieto
agitation	ruido
agog	curioso
agonizing	horrible, horroroso
agony	angustia, miedo
agrarian	agrario
agree	convenir; acordar, declarar
agreeable	agradable
agreed	deacuerdo, enorden, vale, conforme, convenido
agreement	acorde, acuerdo, concordación, convenio; acuerdo, arreglo, convenio; declaración
agree	estardeacuerdocon
agricultural	agrario
ague	fiebre
ah	ay; ah
aha	ah
ahead	anteriormente, delante; adelante
aid	asistente, ayudante; ayuda; ayudar; ayuda
aide	ayudante, edecán
ailment	enfermedad
aim	quererdecir; fin, objeto; esforzarsepor, tratarde
air	aeróstato
air	aire
airbed	hinchable
aircraft	avión
airdrome	aeropuerto
airfield	aeropuerto
airless	oprimido
airmail	correoaéreo
airplane	aeroplano, avión
airport	aeropuerto; aeropuerto
airsick	mareadoenavión
airy	hueco
air	deaireacondicionado
air	aireacondicionado; aireacondicionado
air	cartaaérea
air	hinchable
air	ventilar
alarm	alarma; preocupar
alarmbell	timbredealarma
alarming	crítico, grave
alas	esunalástima
album	álbum
alcohol	alcohol; alcohol
ale	cerveza
algebra	álgebra
alibi	coartada
alien	abominable, horrible, horroroso; extranjero; extranjero
alike	semejante
alimony	asistencias
alive	vivo
all	omnisciente
all	omnipotente, todopoderoso
all	todaclasede; todo; todos
alley	calleja
allow	dejar; permitir
all	entodaspartes
all	degolpe, derepente, desopetón
all	denuevo, otravez
all	todaclasede
all	todaclasede
all	cada, cadauno, todo
all	continuamente
almanac	almanaque, calendario
almighty	omnipotente, todopoderoso
almond	almendra
almond	pastadealmendras
almost	casi
almound	pasteldealmendra
alms	limosna
alone	solo, único
along	alolargode
alphabet	abecé, alfabeto; abecé, alfabeto
already	ya
also	también
altar	altar
alter	cambiar, mudar
alternate	alternar
alternation	alternativa
although	aunque
altitude	altitud, elevación
altogether	todo
alum	alumbre
aluminium	aluminio
aluminum	aluminio
always	siempre
amateur	aficionado
amaze	asombrar
ambassador	embajador; embajador
amber	ámbaramarillo
amen	amén
ammonia	amoníaco
amnesty	amnistía
among	entre
amortize	amortizar
amount	número; cantidad, importe, suma
amount	ascendera, importar
amputate	amputar
amuse	divertir, entretener
amusement	diversión, divertimento
amusing	cómico, divertido
an	un, una
anathema	anatema; anatema
anchor	ancla; anclar, fondear
anchovy	anchoa
ancient	antiguo
and	y
and	asícomo, ytambién; asícomo, ytambien
and	asícomo, ytambién; asícomo, ytambien
anecdote	anécdota
anew	denuevo, otravez
angle	ángulo
anguish	angustia, miedo
animal	animal; animal, bestia
anise	anís
ankle	tobillo
annals	anales
annex	anexar, anexionar
annexation	anexión; edificioanexo
annotation	anotación; apunte
announce	anunciar, publicar
announcement	anuncio; noticia, noticias, publicación
annual	anualmente
annul	anular, contramandar
anonymous	anónimo; anónimo
another	otro
answer	corresponderal; contestar, responder; contestara, respondera; contestación, respuesta
answer	corresponderal
ant	hormiga
antecedent	antecedente; antecedente
antenna	antena
antifreeze	anticongelante
antique	antiguo
antiquity	antigüedad
antiseptic	antiséptico; antiséptico; antiséptico
anus	ano
anvil	yunque
anvil	podaderademanotipoyunque
anxious	inquieto
any	alguien, alguno, cierto; unas, unos
anybody	alguien, alguno, cierto
anything	algo
apart	aparte, particular, separado; aparte, porseparado
apartment	apartamento, cuarto, piso
apart	excepto, menos; ademásde, aménde
ape	mono
apocryphal	apócrifo
apologize	disculparse
apology	disculpa
apoplectic	apoplejía
apostasy	deserción
apostate	apóstata
apostatize	apostatar; desertar
apostle	apóstol
apparatus	aparato
apparent	demostrable
apparently	evidentemente
appeal	apelación; llamada; oración, ruego
appeal	llamar
appear	aparecer; parecer; parecer
appearance	aspecto, vista; apariencia
appear	parecer
appease	calmar, sosegar
appellation	nombre
appendix	apéndice
appetite	apetito
applaud	aplaudir
apple	mermeladademanzanas, salsademalzanas; mermeladademanzanas, salsademanzanas
apple	tartademanzana
apple	manzano
apple	manzana
apple	jugodemanzana
apply	emplear
appoint	nombrar
appointment	nombramiento; cita
appointment	agenda, dietario
appointment	nombramiento
appraise	estimar
appreciate	gustar
apprehension	arresto, detención; arresto, detención
appropriate	conveniente
approval	aplauso
approximately	aesode, apróximadamente, cercade
apricot	albaricoquero; albaricoquero
apricot	albaricoque
aptitude	talento; capacidad, disposición, talento
aquarium	acuario
arabesque	arabesco
arch	archi?, arzo?
archbishop	arzobispo; arzobispo
archbishopric	arzobispado
archduke	archiduque
archimandrite	abad
archipelago	archipiélago; archipiélago; archipiélago
architect	arquitecto
archive	archivo
archives	archivo
archivist	archivista, archivero
are	grupo
arena	arena, redondel
argument	argumento
arise	subir; nacer
aristocrat	aristócrata
ark	arca
arm	armar; brazo
armchair	butaca, sillón
army	ejército; ejército
aroma	olor
around	alrededorde, entornode
arrange	arreglar
arrangement	acuerdo, arreglo, construcción
arrears	atrasos
arrest	arresto, detención; arrestar, detener; arresto, detención
arrested	detenido
arrival	aprovisionamiento; llegada; aprovisionamiento
arrivals	aprovisionamiento; aprovisionamiento
arrive	llegar
arrive	venirdespués
arrogant	arrogante; arrogante; arrogante; arrogante
arrow	flecha
arse	ano
art	arte
artery	arteria
arthritis	gota
artichoke	alcachofa
article	artículo; artículo; artículo; objecto
artificial	artificial
artillery	artillería
artilleryman	artillero; artillero
artist	artista
artistic	artístico
as	si; atítulode, como; así; porque, puestoque, yaque
asbestos	amianto
ascend	subir; subir; ascender, escalar, subira
ash	ceniza; fresno
ashamed	vergonzoso
ashen	ceniciento
ashtray	cenicero
ask	preguntar; demandar, pedir, solicitar
ask	demandar, pedir, solicitar
ask	preguntarse
asparagus	espárrago
aspect	aspecto, vista
asphalt	asfalto
aspirin	aspirina
ass	burro
assailant	agresor, atacador
assault	acometer, atacar; acometer, asalter; agresión, ataque, atentado, salteo
assent	asentir, confirmar
assessment	tasa
asset	adquisición, compra, ganancia
assets	activo
assist	ayudar
assistant	asistente, ayudante
associate	juntarse; juntarse, unirse
assortment	surtido
assure	asegurar
aster	aster
asthma	asma
astronaut	astronauta
asylum	asilo, refugio
as	comosi
as	encuantoa, porlotocantea, respectode
as	comosi
as	encuantoa, porlotocantea, respectode
as	asícomo, ytambién; asícomo, ytambien
at	a; cercade
athlete	atleta
athletic	atlético
athletics	atletismo
atlas	atlas
atmosphere	atmósfera
atmospheric	atmosférico
atom	átomo
atom	bombaatómica
atpersand	arroba
attach	fijar
attachement	afectuosidad
attachment	afectuosidad; afectuosidad; afectuosidad
attack	acometer, atacar; acometida, agresión, ataque
attacker	agresor, atacador
attain	alcanzar, consequir, obtener, procurarse; alcanzar
attempt	esforzarsepor, tratarde; afán; intentar, probar; carné, carnet
attend	cuidar; visitar
attendance	servicio
attention	atención
attentive	atento; atento
attic	desván
attitudinize	darsetono, ponerse, serpresuntuoso
attitudinizer	farsante, presumido
attract	atraer, encantar, seducir; atraer
attractive	atractivo, atrayente
attune	acomodar, adaptar
at	enteramente
at	alamanecer
at	enunprincipio; enunprincipio
at	encasa
at	alfin, finalmente, porfin
at	alomenos, almenos; alomenos
at	porlomás; porlomás
at	directamente, enseguida; ahoramismo, enelacto, enseguida, inmediatamente
at	actualmente, ahora
at	ahí, allí
at	aldorso; atrás, detrás, enpos
at	ainstanciasde
at	enunprincipio; enunprincipio
at	atiempo
at	almismotiempo, juntamente
aubergine	berenjena
audience	audiencia
audit	controlar, registrar, revisar
auditorium	aulamagna, paraninfo
aunt	tía
author	autor; autor
authority	autoridad
authorization	autorización
autobus	autobús
autocrat	autócrata
automatic	automático
automoton	automático
autonomic	autónomo
autonomous	autónomo
autumn	otoño
avail	aprovechar
available	disponible
avalanche	avalancha
avenge	vengar
avenge	vengar
avenue	avenida
average	centro, medio
aversion	aversión, repugnancia
aviation	aviación
avidity	deseo
avoid	evitar
await	esperar; aguardar, esperar
award	premiar
away	lejos
awful	abominable, horrible, horroroso
axe	hacha
axiom	axioma
axis	eje
axle	eje
a	aldía
a	unas, unos
a	unmomento
a	bastante, poco; poco, poquito, tantico
a	mucho; mucho
a	unmomento
a	procedentede
baby	bebé, nene
bachelor	solterón
back	puertatrasera
back	reverso, revés; espalda; partetrasera, revés; revés; atrás
background	fondo; fondo
backpack	mochila
backward	bocaarriba, deespaldas; atrás, haciaatrás; atrasado; retrógrado
backwards	atrás, haciaatrás; bocaarriba, deespaldas, atrás; atrás
back	occipucio
back	barriobajo
back	ruedaposterior
bacon	tocino
bacterium	bacteria
bad	malo; podrido
bad	malasuerte
bag	bolso; bolso
bagasse	bagazo
baggage	equipaje, equipajes
bairn	niño
bait	carnada, cebo
baize	bayeta
bake	cocer
baked	hornada, pastel
baker	panadero
bakery	panadería
balance	balancear
balance	balance
balcony	balcón
bale	bala, fardo
baleen	ballena; ballena
ball	baile; pelota
ballast	lastre
ballet	ballet
ballet	bailaríndeballet
balloon	aeróstato; aeróstato
ballot	balotaje
balloting	balotaje
ballpoint	bolígrafo
balm	bálsamo
balsam	bálsamo
balustrade	balaustrada
bamboo	bambú
ban	anatema; anatema
banana	plátano; plátano
bandage	vendaje; vendaje
bandit	bandido
banisters	balaustrada
bank	billetedebanco
bank	banco, escaño
banker	banquero
banking	cuentabancaria
bankruptcy	bancarrotaquiebra
bank	cuentabancaria
bank	banquero
banner	bandera
banquet	banquete; banquete
bar	cercar; obstrucción; taberna; salvo; estorbar, impedir; estorbar, impedir; bar
barbarian	bárbaro
barbaric	bárbaro
barber	barbero; barbero; peluquero; barbero
bare	desnudo
barefoot	descalzo
barely	apenas
baritone	barítono
bark	corteza; barco; ladrar; cáscara
barley	cebada
barman	barman
barn	barraca, cobertizo; cabina, granero, puesto
barometer	barómetro
barometer	alturabarométrica
baron	barón
baroness	baronesa
barque	barco
barrack	barraca, cobertizo
barracks	cuartel; cuartel
barren	árido
barricade	barricada
barrier	obstrucción, reja; obstrucción
barring	salvo
barrister	abogado
barrister	abogado
bartender	barman
bar	barradechocolate
bar	taburete
bas	bajorrelieve
basalt	basalto
base	basar, fundar
basement	sótano
basic	bázico
basin	recipientedeagua; fuente, pelvis
basket	cesto
basketball	baloncesto
bass	bajo; perca
bass	bajo
bast	corteza
bastard	bastardo
bath	baño; baño
bathe	bañar; bañarse
bathing	trajedebaño
bathing	cabina; cabina
bathing	trajedebaño
bathroom	cuartodebaño, establecimientodebaños, estaciónbalnearia; cuartodebaño
baths	bañero
bath	bañero
batiste	batista
baton	palo
battalion	batallón
battery	acumulador; batería; batería, pila
battle	batalla
battlefront	frontón
bay	bahía
bazaar	bazar; bazar
beach	playa
beacon	baliza
beak	pico
beam	rayo; viga
bean	haba
bear	daraluz, parir; producir; oso
beard	barba
bearing	abolas
bear	costear
beast	animal, bestia
beastly	bestial
beat	golpear
beautiful	bonito
beauty	belleza
beaver	castor
because	porque, puestoque, yaque; porque, puestoque, yaque; porque, puestoque, yaque
because	conmotivode
become	acontecer, hacerse; hacerse
becoming	conveniente
bed	ropadelacama
bed	cuadro; cauce, madre; cama, lecho
bedding	ropadelacama
bedridden	encamado
bedspread	colchadecama
bedstead	camita
bee	abeja
beech	haya
beef	carnedevaca
beefsteak	bife, biftec, bisté, bistec
beer	cerveza
beet	remolacha
befit	convenir
before	antes, delantede; antesdeque
beg	mendigar, pedirlimosna; demandar, pedir, solicitar
beggar	mendigo
begging	mendicidad
begin	comenzar, decentar, empezar, enteblar; comenzar, empezar, principiar
beginner	debutante, principiante
beginning	comienzo, origen, principio; comienzo, principio
begrudge	deplorar
behave	conducirse
behead	cortar
behind	atrás, detrás, enpos; detrásde, tras; aldorso, atrás, detrás, enpos; después
behold	tenga
beige	beige
believe	creer
bell	campanilla, timbre; campanilla, timbre
belly	vientre
belong	pertenecera, serde; pertenecera
beloved	querido, novio
below	abajo, enelfondo; debajode; abajo
belt	cinto, cinturón, pretina
bench	banco
bend	curvar, doblar; curvar, doblar; curva
beneath	debajode
benefit	ventaja; provecho; provecho, ventaja
bengal	luzdeBengala
bengal	luzdeBengala
beret	birrete; boina
berry	baya
beside	cercade
besides	ademásde, aménde; además; demás, además
besiege	asediar, sitiar
best	querido
bestial	bestial
bet	apostar
better	mejor
between	entre
beverage	bebida
bevy	grupo
beyond	después, luego; atravésde
be	poder
be	derivardelrumbo
be	temer
be	vivir
be	convenir
be	avergonzarse
be	dormir
be	alojarse
be	atreverse
be	nacer
be	quemar
be	llamarse
be	entrarencuenta
be	dependerde
be	quedarseatrás, tardar
be	dañara
be	diferir
be	acampar
be	convenir
be	estar, encontrarse, hallarse; encontrarse, hallarse
be	capitanear
be	quedarseatrás, tardar
be	faltar
be	atrasarse
be	estar, encontrarse, hallarse; encontrarse, hallarse
be	casarse; casarse; casarse
be	faltar
be	pertenecera
be	alojarse
be	envejecer
be	doler
be	callarse
be	parecerse
be	quedar
be	deplorar, sentir
be	convenir
be	caerenfermo
be	serarrojadoalaplaya; serarrojadoalaplaya
be	valer
be	merecer
be	notenerrazón
bib	babero
bicarbonate	bicarbonato
bicuit	bizcocho
bicycle	bicicleta; bicicleta
bid	ofrecer; demandar, pedir, solicitar
bide	aguardar, esperar
big	grande
bike	bicicleta; bicicleta
bikini	biquini
bile	bilis
bill	pico; billete; podadera; cuenta; cuenta
billow	oleaje
bind	liar, ligar
binding	encuadernación
birch	abedul
bird	ave, pájaro
birds	aves
birth	nacimiento
birthday	cumpleaños
biscuit	bizcocho, galleta
bishop	obispo
bit	tela, pedazo
bite	morder; mordisco
bitter	amargo
black	negro
blackberry	zarzamora; zarza
blackberry	zarza
blackbird	mirlo
bladder	vejiga
blame	valoraren; culpa; reprender, reprobar
blameworthy	censurable, reprobable
blank	blanco; formulario, hoja
blanket	manta
blaspheme	jurar
bleak	horrible, lúgubre; afligido, triste; frío
bleed	sangrar
bleeding	sangría
blind	ciego
blind	caminosinsalida
blister	ampolla; ampolla; campanilla
block	bloque
blond	rubio
blood	sangría
blood	ensangrentado; ensangrentado
blood	sangre
bloom	flor
blot	mancha
blotter	papelsecante
blotting	papelsecante
blouse	blusa
blow	golpe; soplar
blue	azul
blueberry	mantequilla
blunt	embotado, obtuso; arromar, despuntar
blushing	rojo
boar	cerdo
board	tabla
boarding	casadehuéspedes, pensión
boarding	casadehuéspedes, pensión
boat	barco
body	carrocería; cuerpo
boil	hervir
boiled	huevofrito
bold	grueso
bomb	bomba
bon	bombón
bonbon	bombón
bond	cinta, lazo
bone	hueso
bonnet	capot
book	contable, tenedordelibros
book	libro; pedir; reservar
bookcase	armarioparalibros, libréria
bookseller	librero
bookshop	librería
bookstore	librería
boot	bota
booze	alcohol
border	borde
bore	barrena; aburrir
boring	aburrido; aburrido
borrow	prestar; prestar
bosom	pecho
boss	amo, capitán, caudillo, comandante, dueño, jefe, patrón; dueño; amo, capitán, caudillo, comandante, jefe, patrón
both	ambos, losdos
bother	incomodar, molestar
bottle	botella; vaciar
bottle	abridordetapones
bottom	suelo; ladoinferior
bough	rama
bouillon	caldo
boundary	frontera
boutique	tienda
bowl	fuente, pelvis
box	arca, caja; caja; caja, estuche, jarro, olla
boxer	boxeador
boy	chico, muchacho; criado
bra	sostén, sujetador
bracelet	brazalete, pulsera; brazalete, pulsera
braces	tirantes
brain	cerebro
brake	enfrenar; freno
brakedown	averia, pana, panne
bramble	zarza
branch	rama
brandy	coñac
brass	latón; latón
brave	bravo
bray	rebuznar
bread	pan
bread	rebanada
break	adiestrar; descanso; quebrar, romper
breakfast	desayuno
break	demoler, derribar
break	desacostumbrar
bream	brema
breast	pecho
breath	aliento, respiración
breathe	respirar
breathless	jadeante, sinaliento
breed	raza
brevity	concisión
brick	ladrillo
bride	prometida
bridge	puente
bridle	contener, reprimir
brief	corto
briefcase	cartera
briefness	concisión
briefs	braguitas
bright	magnífico; claro
brilliant	magnífico
brim	borde
bring	llevar, traer
bring	llevar
brinjal	berenjena; berenjena
brink	borde
broad	ancho
broken	estropeado; entrecortado, roto
broken	cascajo
brothel	burdel, mancebía
brother	hermano
brothers	hermanos
brow	ceja
brown	marrón, moreno, pardo
brush	cepillar; cepillo
brutal	bronco, brusko
bubble	vejiga
buck	liebremacho
buck	conejomacho
buck	conejomacho; liebremacho
bucket	cubo
buckle	hebilla
budget	presupuesto
buffalo	búfalo
buffer	parachoques
buffet	bar
bug	insecto
build	construir, edificar
builder	destajista; labrador
building	construcción; construcción, edificio
building	destajista
bulb	ampolla
bull	toro
bullet	bola
bullring	plazadetoros; plazadetoros
bumper	parachoques
bumpy	desigual
buoy	baliza, boya
burden	cargar; carga
burdensome	pesado
bureau	oficina
burgomaster	alcade
burial	enterramiento, entierro; enterramiento, entierro
burn	arder; encender, quemar
burnt	quemado
burn	quemar
burst	henderse, resquebrajarse; grieta, hendedura, quebraja; henderse, resquebrajarse
bury	enterrar; enterrar
bus	autobús
bush	arbusto
business	asunto, particular; comercio
businessman	comerciante
business	asunto, particular
busk	ballena
busstop	paradadelautobús
busy	ocupado
busy	estar...ando
bus	paradadelautobús; paradadelautobús
but	excepto, menos; mas, pero
butcher	matar; carnicero
butcher	carnicería; carnicería
butter	mantequilla
butterfly	mariposa
button	botón; botón
buy	comprar, procurarse; comprar, procurarse; comprar, procurarse; comprar, procurarse; comprar, procurarse; comprar, procurarse; adquisición, compra; procurarse; procurarse
buyer	cliente, comprador
by	carreterasecundaria
by	cercade; de, desde; pormediode
bye	adiós; hastaluego, hastalavista
by	porsuerte
by	porsuerte
by	dedia; dedia
by	dememoria
by	pormediode
by	ya
by	deningunamanera
by	apropósito, depaso
cab	aparcamientodetaxis
cabbage	col
cabin	cabana; camarote
cabinet	armario
cable	cable
cactus	cacto
cafetaria	cafetería
caf	café
cake	queque
calabash	calabaza
calculate	calcular, computar
calculation	cuenta
calf	ternero; pantorrilla
call	llamar; llamar
call	cabinatelefónica
call	visitar
calm	quieto; silencio; sosegado, tranquilo; calmar, sosegar
calm	calmarse, sosegarse
calorie	caloría
cambric	batista
camel	camello
camera	cámara; cámara, cámaradepelículas
camp	acampar
camping	campamento, camping, terrenodelcamping
camping	campamento, camping, terrenodelcamping
camp	campamento
camp	acampar
can	lata
canal	canal
cancel	anular, contramandar; anular, contramandar
candle	vela
candlestick	candelero
cane	palo; junco
can	abrelatas
cap	gorro; birrete, gorro
capability	capacidad, disposición
capable	capaz, hábil
capital	capital; capital
capital	capital
capitulate	capitular
capsule	cápsula
capture	asir, coger
car	automóvil, coche
carafe	garrafa
carburettor	carburador
card	tarjeta
care	cuidar; cuidado
career	carrera
careful	circunspecto, precavido, prudente; circunspecto, precavido, circunspecto
careless	descuidado; descuidado
caress	acariciar; caricia
caressing	mimoso, zalamero
care	cuidarsede
care	curar
carnation	clavel
carnival	carnaval, carnestolendas
carpet	alfombra
carriage	coche; coche
carrier	tricar
carrier	tricar
carrion	carroña
carrot	zanahoria
carry	llevar
cart	carro
car	aparcamiento
case	asunto, particular; caso
cash	contante
cashier	caja
casserole	cacerola
castle	castillo; torre
cat	gato
catalogue	catálogo
catch	asir, coger; acertar
catching	contagioso; contagioso
catechism	catecismo
catering	abastacimiento; abastacimiento
caterpillar	oruga
cathedral	catedral
cathode	tuboreceptor; tuboreceptor
catholic	católico
cauliflower	coliflor
cause	causar, instigar, maquinar, ocasionar, producir; causa; darlugara, ocasionar
cause	afligir, entristecer
cause	afligir, entristecer
cause	darlugara, ocasionar
caution	avisar
cautious	circunspecto, precavido, prudente; circunspecto, precavido, circunspecto
cavalier	caballero
cavalry	caballería
cave	cueva; cueva; bache, hueco
cavern	cueva
cavity	bache, hueco; bache, hueco
ceaselessly	continuamente
cede	abandonar, ceder
celebrate	celebrar; celebrarunafiesta
celebrating	celebrarsucumpleaños
celebration	fiesta
celery	apio
cell	célula
cellar	sótano
cello	violoncelo
cemetery	camposanto, cementerio
censor	censurar; censura
censurable	censurable, reprobable
censure	censurar, criticar; desaprobación, reprobación
centennial	siglo
centimetre	centímetro
central	central
central	calefaccióncentral
centre	centro
century	siglo
ceremony	ceremonia; ceremonia
certain	cierto
certainly	ciertamente
certificate	acta, certificado; certificado, certificación
chain	cadena
chain	cordillera, sierra
chair	silla
chalk	greda
chamber	cuarto, habitación
chamber	orinal
champagne	champaña
chance	acaso; acontecimiento; suerte
change	cambiar, mudar; monedas; cambiar, mudar; combiar; cambio
channel	canal
chaos	caos
chaotic	caótico
character	indole, naturaleza; naturaleza; seña
charcoal	carbón
charge	gastos; acusación, cargo; carga
chariot	carro
charitable	misericordioso
charity	limosna; misericordia
charm	embelesar, encantar; encanto, gracia
charming	bonito, encantador, lindo
chase	perseguir; cazar
chasm	abismo, despeñadero, precipicio
chastity	virtud
chat	charlar
chatter	charlar
chauffeur	chauffeur, chófer, mecánico
cheap	barato
cheat	embustero; engañar
check	contener, reprimir; controlar, registrar, revisar; cheque
checked	acuadros
checker	inspector
checkers	damas, juegodedamas; damas
check	controlar, registrar, revisar
cheek	mejilla
cheer	animar, incitar
cheers	asusalud
cheese	queso
chef	jefe
chemist	boticario, farmacéutico; químico; químico
chemistry	química; química
chemist	botica, farmacia
cheque	talonario
cheque	cheque
chequered	acuadros
cherry	cereso
cherry	cereza
chest	pecho; arca, caja; aparador
chestnut	castaño; castaño
chestnut	castaña
chew	masticar
chewing	chicle
chic	elegante
chick	pollo
chicken	pollo; gallina
chicory	achicoria
chief	archi?, arzo?
chief	amo, capitán, caudillo, comandante, dueño, jefe, patrón; jefe; principal; amo, capitán, caudillo, comandante, jefe, patrón
chiefly	sobretodo, principalmente; principalmente, sobretodo
child	niño; niño
child	camitadeniño
chilli	ají
chilly	frío
chimerical	hueco
chin	barba
chippings	cascajo
chisel	cincel
chive	cebollana
chlorine	cloro
chocolate	chocolate
choice	elección
choke	sofocar
cholera	cólera
choose	elegir, escoger
chord	acorde, acuerdo, concordación, convenio
chuck	acariciar; caricia
chunk	bola
church	iglesia
church	iglesia
cider	sidra
cigar	cigarro
cigarette	cigarillo
cinder	ceniza
cinema	cine
cipher	cifra
circle	círculo
circuit	circuito
circular	circular
circumcision	circuncisión
circumference	perímetro
circumstance	condición
circus	circo
cistern	tanque
citadel	ciudadela
citation	cita, citación
cite	citar, mencionar
city	ciudad, población
city	ayuntamiento
civil	civil
civilian	civil
civilization	civilización
claim	derecho, pretensión
clap	aplaudir
clapper	badajo
clarify	desarrollar, explicar
class	clase; cursillo, curso
classify	clasificar
clause	cláusula
claw	garra
clay	arcilla
clean	limpio; limpiar
cleanliness	limpieza
cleanse	limpiar
clear	claro; claro, evidente
clear	recogerlamesa
clergyman	cura
clerk	dependiente, empleado
clever	ágil, experto, diestro, hábil
client	cliente, comprador; cliente, comprador, parroquiano
client	clientela
climate	clima
climb	trepar; subir; ascender, escalar, subira
climber	refugio
clip	cortar
clippings	desechos, detrito
clique	trinquete
cloak	abrigo
cloakroom	guardarropa
clock	reloj
clod	bola
close	cerrar; cómodo; estrecho; entrante, próximo; cerca
closed	cerrado
closet	armario
cloth	tela
clothe	vestir
clothes	armarioropero
clothes	ropa
clothing	ropa
cloud	nube
club	club
clutch	asir, coger; agarrar, asir, coger
coach	carrocería
coach	coche; coche
coarse	áspero, desigual
coast	costa
coat	abrigo; abrigo
cocaine	cocaína
cock	gallo
cockroach	cucaracha
cocoa	cacao
cod	bacalao
code	código
codfish	bacalao
coffee	café
coffee	cafetera; cafetera
cognac	coñac
coin	moneda
cold	frío; resfriado; resfriado
collar	cuello
colleague	colega, compañero; colega, compañero
collect	recoger
collection	grupo; colecta
college	colegio
collide	atropellar
collide	abordar, chocarkun
collision	abordaje, atropallamiento, choque, colisión
colony	colonia
colossus	monstruo
colour	color
column	columna
comb	peinar; peine
combination	combinación
come	descender; venir
come	acontecer, hacerse; acontecer, realizarse, tenerlugar
come	hallar, encontrar
come	venirdespués
come	volver
come	acercarse, aproximarse
come	acercarse, aproximarse
come	venirdespués
come	acercarse, aproximarse
come	juntarse
come	expirar, terminarse
come	parar
come	corresponderal
comfort	anchas; consolar
comfortable	agradable
coming	natural, originario, proveniente
coming	procedentede
command	capitanear; mandato, mando
commander	comandante
commence	comenzar, decentar, empezar, enteblar; comenzar, empezar, principiar
commencement	comienzo, origen, principio; comienzo, principio
commend	alabar; certificar, encarecer, ensalzar, recomender
commerce	comercio
commercial	arroba
commission	comisión
committee	comité
commit	acometer, atacar
commodity	artículo
common	común; común
commonplace	común, trivial
commotion	escandálo
communicate	comunicar, informar; contagiar, inficionar
communication	frenodeemergencia
communication	communicación, noticia; noticia, noticias, publicación
communion	comunión
communist	comunista
community	municipio
company	firma; compañía
compare	comparar
compartment	departamento
compass	brújula
compel	forzar, obligar
compensate	compensar, indemnizar; recompensar
compensation	recompensa
compete	competir
competition	competencia; concurso
complain	quejarse
complaint	acusación, cargo; pleito, queja
complete	cabal, completo; completar, llenar; lleno
completed	acabado, terminado
completely	completamente; completamente
complex	complekso
compliment	cumplimiento
component	ingrediente
composed	dueñodesímismo
composer	compositor
comprise	contener
compulsory	obligatorio
computer	computador, ordenador
concave	hueco
conceal	ocultar
conceited	hueco
concept	idea, noción
concern	importancia; concernir; cuidado
concerned	dicho, encuestón
concerning	encuantoa, porlotocantea, respectode; encuantoa, porlotocantea, respectode; encuantoa, porlotocantea, respectode
concert	concierto
concise	conciso, sucinto
conciseness	concisión
conclude	despachar
conclusion	conclusión
concord	acorde
concrete	hormigón
concurrence	acorde, acuerdo, concordación, convenio
condemn	condenar; desaprobar, reprobar
condemnable	censurable, reprobable
condemnation	desaprobación, reprobación
condition	condición
condom	condom, preservativo
conduct	guiar; conducir, dirigir
conductor	chófer
conduct	conducirse
confectioner	pastelero
confectionery	pastelería
conference	conferencia
confess	confesar, declarar; confesar
confession	confesión, declaración; confesión
confidence	confianza
confine	limitar
confined	limitado
confined	encamado
confirm	confirmar
confirmation	confirmación; confirmación
confiscate	confiscar, embargar
conflagration	incendio
conflict	conflicto
confront	oponerse
congenital	innato
congentital	innato
congratulate	felicitar
congress	congreso
connect	comunicar; liar, ligar
connection	comunicación; enlace, empalme; cinta, lazo
connect	comunicar
conquer	conquistar
consecutively	sucesivamente
consent	acordar, declarar; declaración
consequence	consecuencia
conservation	conservación
conservative	conservador
conserve	conservar, guardar
consider	considerar, contemplar, tomarenconsideración; contemplar, mirar, observar, ver
considerable	considerable, notable
consideration	consideración, contemplación
consignee	destinatario
consistency	consecuencia
consistent	consecuente
consist	componerse
console	consolar
constant	continuo; continuo
constantly	continuamente, siempre
constipation	constipado
constitution	constitución
construct	construir, edificar
consul	cónsul
consulate	consulado
consultation	reflexión; consulta
consume	consumir
consumer	consumidor
contact	contacto
contagious	contagioso; contagioso
contain	contener
container	caja, estuche, jarro, olla
contaminated	contagiado
contempt	desprecio
contented	contento
contest	concurso
continual	continuo
continually	continuamente, siempre
continue	continuar; continuar, durar; continuar
continuous	continuo; continuo
continuously	continuamente, siempre
contract	contrato, destajo
contractor	destajista
contradict	contradecir
contralto	alto
contralto	alto
contrast	contraste
control	contener, gobernar, subyugar, refrenar, reprimir
controller	inspector
convention	congreso
conversance	notoriedad
converse	conversar
conversion	conversión
convert	convertir
convey	alargar, entregar
convince	convencer
cook	cocinar; cocinera; cocinero
cookie	bizcocho, galleta
cool	enfriar; fresco
cool	enfriar
copper	cobre
copy	copiar, trasladar; copia, traslado
cord	cuerda
cork	corcho
corkscrew	sacacorchos
corn	callo; maíz
corner	esquina
corpulent	grueso
correct	correcto; corregir; preciso
correspond	cartearse; empalmar
correspond	corresponderal
corridor	pasillo
corridor	trencorrido
corroborate	confirmar
corruption	corrupción; deterioración, putrefacción
cosmetic	polvos
cost	costar; gastos
costly	caro
costume	traje
cot	camitadeniño
coterie	trinquete
cotton	algodón; algodón
couch	dyschatell; canapé
cough	toser
counsel	abogado; anunciar; aconsejar; consejo
counsellor	consejero
count	entrarencuenta; calcular, computar; contar
counter	mostrador
countermand	anular, contramandar
counterpane	colchadecama
country	campo; país
countryside	campo
count	deducir
count	sumar
couple	embragar
coupon	cupón
coup	departamento
courage	valor, virtud
courageous	bravo
courgette	calabacín
course	cursillo, curso; plato
court	grave, patio
courteous	cortés
courtyard	grave, patio
cousin	prima; primo
cover	encuadernación; cubrir; tápa; neumático; forrar, vestir; recorrer
covered	cubiertodeverdor
covered	ensangrentado; ensangrentado
coverlet	colchadecama
covet	codiciar
covetousness	deseo
cow	vaca
crab	cangrejo
crack	grieta, hendedura, quebraja; grieta, hendedura, quebraja
cradle	cuna, patria
craft	astucia
craftiness	astucia
cramped	estrecho
crash	abordar, chocarkun
crayfish	cangrejo
cream	flan; crema; desnatar
create	creer
credit	haber
credit	tarjetadecrédito
crevice	grieta, hendedura, quebraja
crew	tripulación; tripulación
crime	crimen
crisis	crisis
criticism	censura, crítica, reparo
criticize	censurar, criticar
crockery	cerámica; loza
crocodile	cocodrilo
cross	cruz; atravesar
cross	cruce
crown	coronar
crude	crudo
crude	petróleo; petróleo
crumble	derruirse, desmoronarse
crumble	derruirse, desmoronarse
crumble	derruirse, desmoronarse
cry	grito; llorar
cry	gritar
cubic	cubano
cucumber	pepino
cuddlesome	mimoso, zalamero
cuddly	mimoso, zalamero
cul	caminosinsalida
cultivate	cultivar
culture	cultura
cunning	astucia
cup	taza
cupboard	armario
cure	curar; curar; curar
curious	curioso
currant	grosella; grosella
currant	jugodegrosellas
currency	valuta
current	actual; corriente; corriente; contemporáneo; contemporáneo
currently	ahora, alpresente, hoydía
curry	arrurruz
curse	jurar
curtain	cortina
curve	curva
cushion	almohada
cuss	jurar
custom	costumbre
customer	cliente, comprador, parroquiano
customs	aduana
cut	cortar; cortar
cutlet	chuleta
cuttings	desechos, detrito
cut	decentar, encentar
cut	cortar
cycle	bolsaparabicicletas
cycle	bicicleta; ciclo
cyclone	ciclón
cylinder	cilindro
cymbal	címbalo, platillo
cynical	cínico
cypres	ciprés
daily	detodoslosdías, diario; diariamente
dainty	amable; fino
dairy	lechería
dam	obstrucción, presa
damage	avería; daño; deteriorar; daño, defecto, deterioro
damaged	estropeado
damp	humedo
dance	baile; bailar; baile
dandruff	caspa
danger	peligro
dangerous	peligroso
danger	carreteraresbaladiza
dare	atreverse
dark	oscuro
darkness	tinieblas
data	material
date	dátil; fecha; cita
daughter	hija
dawn	amanecer
day	billeteporundía
day	día
daybreak	amanecer
dazzle	deslumbar
dead	muerto
deaden	amortizar
deaf	sordo
deal	tratar
dear	caro; caro; caro; caro
death	muerte
debris	desechos, detrito
debt	deuda
decanter	garrafa
decapitate	cortar
decay	deterioración, putrefacción; deterioración, putrefacción; baja, decadencia
decayed	decrépito
deceitful	engañoso, falaz
deceive	engañar
deceiver	embustero
decent	conveniente
decently	comoesdebido
deceptive	engañoso, falaz
decide	decidirse, resolver
decimetre	decímetro
decision	decisión; sentencia
decisive	decisivo
deck	cubierta
declaration	declaración
declaration	programa
declare	declarar
decline	desmejorarse; retroceso
decorate	decorar
decoration	alhaja
decrease	disminuir; bajar; amainar, decrecer, disminuir, menguar
decrepit	decrépito
deduce	decudir
deem	creer; contemplar, mirar, observar, ver
deep	profundo
defeat	derrota
defection	deserción
defence	defensa; retaguardia
defendant	acusado; acusado
defense	defensa
define	definir
definite	artículodeterminado
deflect	desviarse
defray	costear
degree	grado
dejected	abatido, desanimado
delay	retraso; retraso
delegate	delegar, diputar; diputado; diputado
delete	enjugar, limpiar
deliberately	depropósito
deliberation	reflexión; consideración, contemplación
delicacy	dulce
delicate	fino
delightful	bonito, lindo
delight	disfrutar
deliver	entregar
delivery	entrega; entrega
delusive	engañoso, falaz
demand	consumo, despacho, salida; deducción; exigir
demolish	demoler, derribar
demolition	demolición; demolición
demonstrative	pronombredemonstrativo; pronombredemonstrativo
demonstrative	pronombredemonstrativo; pronombredemonstrativo
den	cueva
denounce	acusar, delatar, denunciar
dentist	dentista
deny	negar
depart	quitarse, salir
departure	salida
depend	depender
dependence	dependencia
dependent	dependiente
depend	dependerde
depict	reproducir, retratar
depose	destituir
deposit	depositar, ponerendepósito
depository	depósito
depravation	deterioración, putrefacción
depressed	abatido, desanimado
depression	crisis
depth	profundidad
depute	delegar, diputar
deputy	diputado
derivation	derivación
derive	derivar; descender
descend	bajar; bajar, descender
describe	describir
description	descripción
desert	desierto; abandonar; desertar
deserve	merecer
design	dibujar; plano, propósito
desire	desear, querer, tener; deseo
despise	despreciar
dessert	postre
destiny	destino; suerte
destitution	indigencia
destroy	destruir
detail	detalle
detain	retener
detective	detective
detention	arresto, detención; arresto, detención
deter	espantar
determine	determinar; definir; fijar
detract	dañara
develop	revelar
deviate	desviarse
device	aparato
devoted	afectuoso; afectuoso
dew	rocío
dexterous	ágil, experto, diestro, hábil
diabetes	diabetes
diagram	reproducción, retrato; plano, propósito
dial	marcar
diameter	diámetro
diamond	diamante
diarrhoea	diarrea
dictionary	diccionario
die	morir
diet	dieta
differ	diferir
difference	diferencia
different	diferente, disferente, distinto, divergente; desigual; distinto
differently	deotramanera; deotramanera
difficult	dificil
difficulty	inconveniente
dig	cavar
digestion	digestión
digit	cifra
dilapidated	decrépito
dim	oscuro
dimension	dimensión, tamaño
diminish	disminuir; amainar, decrecer, disminuir, menguar
diminutive	chico, pequeño
din	ruido
dining	comedor; comedor
dinner	cena, comida
diploma	acta, certificado
direct	mandar; guiar; derecho
direction	dirección
directly	seguido
director	director
directory	catálogo
dirty	sucio
disabled	inválido
disabled	inválido
disapprobation	desaprobación, reprobación
disapproval	desaprobación, reprobación
disapprove	desaprobar, reprobar
disapprove	desaprobar, reprobar
discard	despedir
discharge	despedir
disciples	partido; partido; partido
discount	bajar; descuento, rebaja, reducción
discourage	espantar
discover	descubrir
discovery	descubrimiento
discrete	discreto
discrimination	discriminación
disease	enfermedad
disgust	aversión, repugnancia
dish	plato; plato
dishwasher	lavaplatos
disinterested	desinteresado
dislike	aversión, repugnancia
dismal	común, trivial; deplorable; horrible, lúgubre; horrible, horroroso; afligido, triste; afligido, triste; menesteroso, miserable, necesitado, pobre
dismiss	despachar, despedir, enviar, expedir; despedir
dispatch	despachar, enviar, expedir; despachar
disposal	tentación
dispose	vender
disposition	talento; capacidad, disposición, talento
disquiet	molestia
dissolve	resolver
dissuade	desaconsejar
distance	distancia
distant	lejano
distinct	claro, evidente
distinguish	distinguir
distract	distraer
distracted	distraído
distraction	distracción; distracción
distress	afligir, entristecer; indigencia
distribute	distribuir
district	distrito; barrio
disturb	incomodar, molestar
disturbance	molestia
ditch	zanja
divan	dyschatell
dive	bucear, zambullirse; bucear
diverge	desviarse
diversion	distracción; distracción
divert	distraer; desviar
divide	apartar, segregar, separar; compartir, dividir
divorce	divorcio
dizzy	mareado
do	cometer, fabricar, hacer, perpetrar
doctor	doctor, médico
document	acta, certificado; documento
dog	perro
doll	muñeca
dollar	dólar
domestic	indígena
done	acabado, terminado
donkey	burro
door	puerta
dose	dosis
dot	punto
double	doble
double	camadematrimonio
doubt	dudar
dough	masa
dove	pichón
downhill	cuestaabajo
downstairs	abajo, enelfondo
down	cuestaabajo
doze	echarlasiesta
do	abolir, abrogar
do	dañara
drag	tirar; remolcar
draining	desagüe
dram	aperitivo
draw	atraer, encantar, seducir; dibujar; igualdad; tirar
drawers	calzoncillos
dream	soñar; sueño
dreary	horrible, lúgubre; horrible, horroroso; afligido, triste; árido
dress	vendar; vestido; vestir; ponerse, vestirse; ponerse, vestirse
dresser	aparador; aparadordecocina, fregadero
dressing	camarera; camarera
dressing	abono
drift	derivardelrumbo
drink	bebida; beber
drinking	aguapotable
drip	gota
drive	propulsión
drivel	desatinar
driver	chófer; chófer; chauffeur, chófer, mecánico
drive	salir
drive	salir
driving	carnetdeconducir
driving	retrovisor
dromedary	dromedario
droop	colgar
drop	caer; gota; amainar, decrecer, disminuir, menguar
drown	ahogarse
drug	medicamento, medicina; aturdir; aturdir
drugstore	botica, farmacia
drum	tambor
drunk	borracho, ebrio
drunkenness	embriaguez
dry	comadrona
dry	seco; enjugar, secar
dual	doble
duck	pato
dues	cuota
dull	embotado, obtuso
dumb	mudo
dump	basurero; basurero
duplicate	multiplicar
during	dedia; dedia
dusk	anonchecer
dust	polvo; quitarelpolvo, quitarelpolvoa
duty	deber
dwell	habitar, morar
dwelling	domicilio
dwelling	domicilio
dye	pintura; color; teñir
each	cada, cadauno, todo
each	cadavez
eager	ávido, codicioso
eagerness	deseo
eagle	águila
ear	pendiente
ear	oreja; espiga
early	temprano
earn	ganar
earnest	serio
earring	pendiente
earth	tierra
earthen	terrestre, terrenal
earthenware	cerámica; loza
earthly	terrestre, terrenal
earthquake	terremoto
earth	satélitedelatierra
easily	fácilmente
east	este
easy	fácil
eat	comerse
edge	borde
edging	borde
edible	comestible
eel	anguila
effective	eficaz, terminante
effectual	eficaz, terminante
efficacious	eficaz, terminante
effigy	efigie
effort	afán; afán
efforts	afán
egg	huevo
eggfruit	berenjena
eggplant	berenjena
eight	ocho
eighteen	dieciocho, diezyocho
eighth	octavo
eighty	ochenta
eight	ochocientos
elbow	codo
elder	ñaño
elder	ñaña
elect	elegir, escoger
election	elección
electric	eléctrico
electricity	electricidad
electric	ventilador
elegant	elegante
element	ingrediente
elements	abecé, alfabeto
elephant	elefante
elevator	ascensor
eleven	once
elm	olmo
else	otro; deotramanera
elsewhere	enotraparte
embalm	embalsamar; embalsamar
embark	embarcarse
embassy	embajada; embajada
embrace	abrazar; abrazar
emerge	aparecer
emergency	crisis
emigrate	emigrar, emigrarse
emissary	embajador
emmet	hormiga
emotion	emoción
empire	imperio
employ	hacerusode, usar
employee	empleado
employment	bolsadetrabajo
empty	vacío; vaciar
encounter	hallar, encontrar; encuentro
encourage	animar, espolear, incitar, inpulsar; alentar, animar
encouragement	animación
encyclopaedia	enciclopedia
end	acabar, concluir, terminar; expirar, terminarse; expiración, vencimiento; fin, final, término
endeavour	esforzarsepor, tratarde
ending	fin, final, término
endive	escarola
endorse	girar
endow	dotar
endure	continuar, durar; tolerar
end	llegar; expirar, terminarse; recalar
enemy	enemigo
energy	virtud
engine	máquina; motor
engineer	ingeniero
engulf	tomar, tragar
enjoy	disfrutar
enjoyable	agradable
enjoy	divertirse
enlargement	ampliación; ampliación
enormous	enorme
enough	bastante; bastante
enter	entrar, montar; inscribir
enterprise	negocio
entertain	distraer
entertaining	cómico, divertido
entertainment	recreación
entire	cabal, completo, entero, todo
entirely	completamente; enteramente
entomb	enterrar
entrance	entrada
entreaty	oración, ruego
envelop	enrollar
envelope	sobre
envious	envidioso
environment	alrededores
environs	alrededores
envoy	embajador
envy	envidiar; envidia
equal	igual
equality	igualdad
equally	idem
erect	edificar; edificar, fundar
err	equivocarse
errand	mensaje, recado
erroneous	malo
error	equivocación, error, yerro
escort	acompañamiento
especially	sobretodo; sobretodo, principalmente
establish	edificar; edificar, fundar
estate	finca, granja
esteem	estimar, respectar; estima, estimación; considerar, contemplar, tomarenconsideración; estima, estimación
estimate	presupuesto; estimar
estimates	presupuesto
evade	evitar
even	liso, plano; igual; mismo; par
evening	noche, tarde
evening	cena
event	acontecimiento
ever	siempre
every	cada, cadauno, todo
everybody	cada, cadauno, todo
everything	todo
everywhere	entodaspartes; entodaspartes
every	todaclasede
every	cada, cadauno, todo
every	cadavez
exact	exacto; preciso
exaction	exacción, extorsión
exactly	justamente; justamente
exaggerate	exagerar
examination	examen; contemplación, vista
examine	examinar, registrar, revisar
example	ejemplo
exceed	aventajar
except	excepto, menos; ademásde, aménde
except	ademásde, aménde; salvo
exchange	curso
excise	derechosdeconsumo
excise	derechosdeconsumo
excite	instigar
exclude	excluir
exclusively	no...masque, sólo
excommunication	anatema; anatema
excursion	excursión
excuse	dispénseme, pardoneusted
exercise	ejercicio
exhale	respirar
exhausted	agotado
exhibition	exposición
exhortation	exhortación
exile	desterrado; destierro
exist	existir
existence	existencia
exit	salida; salir
expect	esperar
expedite	despachar
expense	gastos
expensive	caro; caro; caro
experience	experiencia
experienced	experto, hábil
expert	experto, hábil
expertness	agilidad, destreza
expire	expirar, terminarse; morir
explain	desarrollar, explicar; desarrollar, explicar
explanation	explicación; explicación
exploit	explotar
exposition	exposición
express	darelpésamea
extend	alargar
exterior	aspecto, vista
external	exterior, externo
extinguish	apagar
extort	arrancar
extortion	exacción, extorsión
extra	extra
extract	extracto
extremely	extremamente
eye	ojo
eyebrow	ceja
eyelid	párpado
fabricate	fabricar
face	cara, faz, fisonomía, rostro
facile	fácil
fact	hecho
faction	partido
factory	fábrica; fábrica
fag	cansar, fatigar
failure	bancarrotaquiebra
faint	débil; desmayarse; desmayo
fair	bazar; rubio; mercado; verbena
faithful	fiel
falcon	halcón
fall	caer; amainar, decrecer, disminuir, menguar
fallacious	engañoso, falaz
fall	adelgazar
fall	caerenfermo
fall	enamorarsede
fall	desmejorarse
fame	conocimientos; hambre
familiarity	notoriedad
family	familia
famous	conocido, famoso; conocido, famoso; famoso; famoso
fan	animar, incitar
fancier	aficionado
fancy	figurarse
fantastic	hueco
far	lejano; lejos
farewell	adiós; despedida
farm	agrario
farm	finca, granja
farmer	campesino
far	lejos
fashion	moda
fast	ayunar; fijo; rápido; deprisa, pronto
fasten	fijar; apretar
fast	rápido; rápido
fat	grueso; gordo, grueso; grasa
fate	destino; suerte
fateful	fatal
father	padre; padre
fatherland	patria
fatty	gordo, grueso
faucet	grifo
fault	culpa
favor	favorecer; favor
favour	favorecer; favor
favourable	favorable
fa	frontón
fear	angustia, miedo; temer; temor
fearful	angustioso, medroso
feast	banquete
feather	pluma
federal	federal
feed	dardecomer; alimentar
feel	sentir; sentirse; sentimiento
feeling	sentimiento
feign	fingir
felloe	llanta
fellow	hombre
felly	llanta
female	feminino
female	gata
female	cocinera
female	peluquera
female	periodista; periodista
female	obrera
female	pariente
female	cantora
female	mecanógrafa
female	costurera
female	maestra
femal	obrera
femal	obrera
feminine	feminino
fence	obstrucción, reja
ferry	transbordador
fertile	fértil
fertilization	abono
fertilize	abonar
fervor	celo
fervour	celo
festival	fiesta
fetch	llevar, traer; buscar, coger, irpor
fever	fiebre
fewer	menos
fianc	prometido
fianc	prometida
field	campo; campo; campo; campo
fifteen	quince
fifth	quinto; quinto
fig	higuera; higuera
fig	higo
figurative	figurado
figure	cifra; reproducción, retrato; calcular, computar
file	lima; cartera; turno
files	archivo
fill	llenar
filling	estacióndeservicio
fill	llenar
fill	llenar
film	película; carrete
filter	filtro
filthy	sucio
fin	aleta
finally	alfin, finalmente, porfin
find	hallar, encontrar
find	estar, encontrarse, hallarse; encontrarse, hallarse
fine	bonito; excelente; fino; multar; multa
finger	dedo
finish	acabar; acabar, concluir, terminar; acabar
finished	acabado, terminado; listo
finishing	acabado
finnish	despachar
fir	abeto
fire	advertidordeincendios
fire	fuego; incendio; despedir; tirar; animar, incitar; animar, incitar
firebrand	instigador
firecall	advertidordeincendios
firing	cápsula
firm	fijo; firma; fuerte, sólido; fuerte, sólido
first	puestodePrimerosAuxilios
first	primero; alprincipio, antes, enprimerlugar, primeramente, primero
firstly	alprincipio, antes, enprimerlugar, primeramente, primero
first	primerossocorros; primerossocorros
first	nombredepila
first	alprincipio, antes, enprimerlugar, primeramente, primero
fish	pescar; pez
fisherman	pescador
fishing	caña, cañadepescar
fission	atomización
fist	puño
fit	acomodar, adaptar; apoplejía
fitness	capacidad, disposición
fitting	conveniente
five	cinco
fix	acomodar, adaptar; determinar; fijar; reparar
fixed	fijo
flag	bandera; bandera, estandarte
flake	desconcharse
flame	llama
flannel	franela
flat	plancha
flat	apartamento, cuarto, piso; liso, plano; bastidor; llano
flatter	adular
flavour	olor
flaw	grieta, hendedura, quebraja
flea	pulga
flee	huir
fleece	estafar
flesh	carne
flight	vuelo
float	nadar
flood	pleamar; pleamar; enterrar
floor	piso; suelo
flour	harina; harina
flow	correr; corriente
flower	flor
flu	gripe
flute	flauta
fly	volar; mosca
foam	espuma
fog	niebla
fold	doblar
folk	población, pueblo
follow	seguir; venirdespués
followers	partido; partido
following	partido; consecutivo, siguiente, sucesivo; partido; próximo, entrante
fondle	acariciar
food	comestibles, plato; alimento
fool	engañar
foolish	zote
foot	pie; pie
for	para; porque, puestoque, yaque
forbid	prohibir
force	forzar, obligar; fuerza, virtud
forehead	frente
foreign	extranjero
foreigner	extranjero; extranjero
foresee	esperar, prever
forest	bosque
foreward	adelante
forget	olvidar
fork	tenedor
forks	cubierto
form	formulario, hoja
former	pasada; pasado
formerly	anteriormente, delante
forsake	abandonar
forswear	abjurar
fortification	alcázar
fortress	fortaleza
fortunately	porfortuna
fortune	suerte
for	porejemplo
for	porejemplo
for	ensumayorparte; ensumayorparte
for	ensumayorparte; ensumayorparte
for	porque, puestoque, yaque; porque, puestoque, yaque
for	provisionalmente
found	edificar, fundar
foundation	suelo
fountain	fuente; fuente
four	cuatro
fourteen	catorce
fourth	cuarto; cuarto
fowl	aves; gallina
fox	zorro
fragment	pieza
free	gratuito
freezing	helada
frequently	amenudo
fresh	fresco
freshen	aumentar
fresh	aguadulce; aguadolce
friend	amiga; amigo
friendly	amable, bonito, gracioso
friendship	amistad
frieze	frisio, frisón
fright	angustia, espanto, miedo
fringe	borde
frivolous	hueco; hueco
frog	rana
frog	ancasderana
from	de; desde; de
front	frontón
frontage	frontón
frontier	frontera
frost	helada; helada
froth	espuma
fruit	frutal
fruit	fruta
fry	freir
frying	sartén
frying	sartén
fuel	depósitodegasolina
full	lleno
fully	completamente
fun	diversión, divertimento; placer
function	funcionar; cargo; cargo, función, oficio
fund	caja
funeral	enterramiento, entierro; enterramiento, entierro
fungus	seta
funnel	embudo
funny	cómico, divertido
fur	incrustación; piel; piel
furious	torcido
furnace	estufa
furnish	entregar
furniture	ajuar, mobilario, mueblaje
fur	piel
fur	piel
future	entrante, próximo; porvenir
fuzzy	brumoso
gag	broma, burla, chanza
gain	adquisición, ganancia; ganar; provecho; provecho
gaiter	polaina
gall	bilis
game	juego
gangway	paso
gaol	prisión; prisión; prisión
garage	garaje
gardener	jardinero
garlic	ajo
gas	gas
gasolene	bencina, gasolina
gasoline	bencina, gasolina
gas	botelladegas
gas	botelladegas
gas	depósitodegasolina
gate	paso; puerta
gateway	puerta
gather	decudir; recoger; decudir
gaunt	fino; afligido, triste; afligido, triste
gazette	periódico
gear	cajadecambios; cajadecambios
gear	cajadecambios; cajadecambios
gem	joya
general	general, universal
generally	generalmente
generative	sexual
gentle	dulce
gentleman	caballero, señor
genuinly	deveras, enefecto, enrealidad, verdaderamente
geographer	geógrafo; geógrafo
geographic	geografía
geographical	geografía
geography	geografía
get	alcanzar, consequir, obtener, procurarse; llegar; alcanzar; procurarse; buscar, coger, irpor; hacerse; buscar, coger, recoger, tomar; procurarse; obtener, recibir
get	enfriar
get	ponerse, vestirse
get	casarse; casarse; casarse
get	enmohecerse
get	bajar, descender
get	bajar
get	abolir, abrogar
get	levantarse; subir; levantarse
get	acostumbrarse, habituarse
ghastly	horrible, lúgubre; horrible, horroroso
gherkin	pepino
gift	regalo; regalo
gifted	dotado, talentoso; dotado, talentoso
gill	branquia
gin	ginebra
ginger	jengibre
giraffe	jirafa
girder	viga
girdle	cinto, cinturón, pretina
girl	muchacha
give	alargar, dar; ofrecer, presentar, reproducir, retratar
give	ventilar
give	fingir
give	llamar, tocarlacampanilla
give	multar
give	devolver
give	daraluz, parir
give	abandonar, ceder
give	anunciar, publicar
give	oler
give	afligir, entristecer
give	causar, instigar, maquinar, ocasionar, producir
give	ladrar
give	abandonar, ceder
give	abandonar, ceder
glad	alegre
gladness	alegría
glass	vaso; vidrio
glasses	gafas
globe	globoterráqueo
glorious	famoso
glove	guante
glue	cola; pegar; cola
go	ir, dirigirse, irse; conducir
goal	fin, objeto
goat	cabra
goblet	cáliz, copa
going	retroceso
gold	oro
goldfish	pezdecolores, pezdorado
good	despedida
good	amable, bonito, gracioso
good	bueno
goodbye	adiós; despedida; hastaluego, hastalavista
goodness	bondad
good	buenosdías
good	buenastardes
good	asusalud
good	buenosdías
good	buenasnoches
goose	ganso, oca
gooseberry	grosella
goulash	estofadodecarnehúngaro
gourd	calabaza
gout	gota
govern	capitanear, subyugar; contener, gobernar, subyugar, refrenar, reprimir
government	gobierno
gown	vestido
go	extraviarse
go	quitarse, salir
go	desmejorarse; retroceder; volver
go	retroceder
go	atravesar; atravesar
go	bajar; bajar, descender
go	envejecer
go	apresurarse
go	entrar, montar
go	envejecer
go	continuar
go	salir
go	recorrer
go	acostarse
go	subir; subir
grab	asir, coger
grade	grado; fila
gradually	pocoapoco
gram	gram
grammar	gramática
gramme	gram
grammophone	disco
grandfather	abuelo
grandmother	abuela
grandson	nieto
granite	granito
grape	uva
grapefruit	pomelo
grapevine	parra
grapple	agarrar, asir, coger; asir, coger
grasp	asir, coger; agarrar
grass	hierba, yerba
grasshopper	saltamontes
gratitude	gratitud; gracias
grave	crítico, grave; tumba
graveyard	camposanto, cementerio
gravy	salsa
grease	grasa
greasy	gordo, grueso
great	excelente; grande
greatgranddaughter	bisnieta
greatgrandson	bisnieto
greediness	deseo
greedy	ávido, codicioso
green	verde; verde
greet	acoger, saludar
greeting	acogida, saludo; saludo
grey	gris, pardo
grieve	afligir, entristecer
grind	moler
grip	asir, coger; gripe
grisly	horrible, lúgubre
groan	gemir
grotto	cueva
ground	pisobajo
ground	suelo; terreno
grounds	terreno
group	grupo; grupo
grow	acontecer, hacerse; hacerse; aumentar, crecer; cultivar
grown	cubiertodeverdor
growth	aumento, incremento
grub	cavar
gruesome	abominable, horrible, horroroso
gruff	bronco, brusko
guarantee	garantía
guard	guardar; vigilar; guardia; cobrador, revisor
guess	adivinar; asumir, suponer
guest	huésped
guide	mandar; guiar; guía; guía; conducir, dirigir
guidebook	guía
guilder	florin
guile	astucia
guileless	cándido, ingenuo
guilt	culpa
guiltless	inocente
guilty	culpable
gulden	florin
gulf	abismo, despeñadero, precipicio
gum	encía
gumbo	ñajú
gun	escopeta
gunner	artillero; artillero
habit	malacostumbre, resabio; costumbre
hackneyed	redicho, trillado; redicho, trillado
haddock	merluza
haemorhoids	almorranas, hemorroides
hail	granizo
hairdresser	peluquera; peluquero
hairy	peludo, velludo
half	medio; medio
hall	vestíbulo
halt	parar; parar
ham	jamón
hamlet	pueblecito
hammer	martillo
hamper	dificultar
hand	bolsa
hand	alargar, entregar; obrero, trabajador; mano; alargar, entregar
handbook	guía
handicap	impedimento
handicraft	oficio
handiwork	artesanía
handle	tratar
handlebars	timón, volante
handsome	bonito
hand	alargar, entregar; alargar, entregar
hang	colgar; colgar
hang	sujetar, tener
happen	acontecer, hacerse; acontecer, realizarse, tenerlugar
happy	alegre
harbor	puerto
harbour	puerto
hard	redicho, trillado
hard	duro; dificil; duro
hardly	apenas
hardworking	activo, laborioso
hare	liebre
haricot	judía, judíaverde
harm	dañara, perjudicara; daño, detrimento
harsh	bronco, brusko
harvest	cosecha
haste	prisa
hastily	precipitadamente
hat	sombrero
hate	odiar; odio
haul	tirar
have	tener; obtener, recibir
have	bañarse
have	divertirse
have	compadecera, dolersepor
have	tener
have	tenerque
hay	heno
hazard	acaso; arriesgar; riesgo
hazardous	arriesgado
hazelnut	avellana
he	cabrón
he	él
head	guiar; cabeza; cabeza; cabeza; cabeza; efigie
headlight	faro
head	capitanear, subyugar
heal	curar; curar
health	salud
heap	grupo
hear	oír
hearing	aparatoparasordos; aparatoparasordos
hearsay	hambre
heart	corazón
heartburn	acidezdeestómago
heat	calentar; calor
heath	brezal
heating	calefacción
heaven	cielo
heavy	pesado
hectolitre	hectolitro
hedge	cizallaparasetos, tijeraparasetos
hedge	cizallaparasetos, tijeraparasetos
heel	talón; tacón
height	altura; altitud, elevación
height	alturabarométrica
helm	timón, volante
help	ayuda; ayudar; ayuda
helper	asistente, ayudante
helpful	oficioso, servicial
her	su; ella; su
herb	hierba, yerba
herd	grupo
here	tenga
here	tenga
herring	arenque
hesitate	titubear, vacilar; titubear, vacilar
hesitation	duda, vacilación; duda, vacilación
hidden	oculto, secreto
hide	piel; ocultar; ocultarse
hideous	abominable, horrible, horroroso; horrible, horroroso
hide	ocultarse
high	alto
high	plemear
hill	colina, loma
hillside	cuesta
him	él
hinder	dificultar; estorbar, impedir; incomodar, molestar
hindrance	molestia
hind	ruedaposterior
hip	cadera
hippo	hipopótamo
hippopotamus	hipopótamo
hire	alquilar, arrendar
hired	alquilado
hirsute	peludo, velludo
his	su
history	historia
hit	golpear; llamar; acertar
hoax	engañar
hoe	azada
hog	cerdo
hold	continuar; sujetar, tener
hold	valoraren
hold	retener
hole	zanja; agujero
hollow	hueco; hueco
homy	cómodo
honest	honrado, sincero
honey	miel
honor	homenaje, honor
honour	homenaje, honor
hood	campana; capot; tápa
hoof	pezuña
hook	anzuelo; gancho
hooker	puta
hooter	bocina; bocina
hope	esperar; esperanza
horizon	horizonte
horn	cuerno; bocina
horrible	abominable, horrible, horroroso; horrible, lúgubre; horrible, horroroso; horrible, horroroso; temeroso
horror	aversión, horror; horror
horse	castaña
horse	rábanopicante
horse	caballo
horsepower	caballos, fuerzadecaballos; caballos, fuerzadecaballos
horseradish	rábanopicante
hospital	hospital
hospitality	hospitalidad
hostel	albergue
hot	caliente
hotel	hotel
hour	hora
house	casa
housefly	mosca
house	servicio
house	iglesia
how	cómo; como; atítulode, como
how	¿cómoestáusted?
how	¿cómoestáusted?
how	¿cuántotiempo?; ¿cuántotiempo?
how	cuánto
how	cuánto
hub	tapacubo, tapon
hub	carretederueda
hug	abrazar
human	hombre
humid	humedo
humiliating	humillante, vergonzoso
humour	humor; humor
hundred	ciento
hunger	hambre
hunt	cazar
hurriedly	precipitadamente
hurry	apresurarse; apresurarse; apresurarse
hurt	doler; herir
husband	esposo, marido
husk	cáscara
hut	cabana
hyaena	hiena
ice	hielo
idea	idea; idea, noción
ideal	ideal
identify	identificar
idol	ídolo
idolatry	idolatría; idolatría
idol	idolatría; idolatría
if	si
ignition	ignición
ignore	desentendersede
iguana	iguana
ill	fatal
illiterate	analfabeto
illness	enfermedad
illuminate	alumbrar, encender
image	grabado, imagen, reproducción, retrato; reproducción, retrato
imagine	figurarse
imitate	imitar
imitation	imitación
immediately	directamente, enseguida; ahoramismo, enelacto, enseguida, inmediatamente
impediment	impedimento
impel	animar, espolear, incitar, inpulsar
impetus	instinto
implore	implorar, suplicar
imply	significar
important	grave, importante
impossible	imposible
imposter	embustero
impulse	instinto
in	a, dentrode, en, por
inborn	innato; innato
inbred	innato; innato
incendiary	bombaincendiaria
incite	instigar; espolear
inclination	tentación
include	contener
including	incluído
inclusively	incluído
inconvenient	dificil
increase	aumentar; ampliación; aumentar; ampliación
increasingly	másymás
incredible	increíble
indecisive	indeciso
indeed	deveras, enefecto, enrealidad, verdaderamente
index	indicación, indicio
indicate	designar, enseñar, indicar; designar, enseñar, indicar, mostrar
indication	agüero; agüero; indicación, indicio
indictment	acusación, cargo
indigence	indigencia
individual	individuo
induce	decudir
inducement	lugar, motivo; lugar, motivo
indulgence	bula, indulgencia
industry	empresa
inebriety	embriaguez
inexpensive	barato
infant	niño
infect	contagiar, infectar, inficionar
infected	contagiado
infection	infección
infectious	contagioso; contagioso
infer	decudir
inference	conclusión
inferior	inferior
inflammation	inflamación
inflate	inflar
influence	influiren
influenza	gripe
inform	informar; informar, divulgar, publicar
information	información
infusion	extracto
ingredient	ingrediente
inhabitant	habitante; habitante
inherit	heredar
inhibit	estorbar, impedir; estorbar, impedir
initial	inicial, primitivo
initial	velocidadinicial
initiate	instigar, maquinar
injection	inyección
injure	deteriorar
injured	herido
injury	herida
ink	tinta
inn	albergue
innate	innato; innato
inner	interior, interna
inner	cámaradeaire
innocent	inocente
inoffensive	cándido, ingenuo
inquiry	oficinadeinformaciones
inquiry	encuesta
inquisitive	curioso
insect	insecto
inside	a, dentrode, en, por; interior, interna; dentro; dentrode
insidious	astuto
insist	insistir, instar
insistence	insistencia, instancia; insistencia, instancia
inspection	visitación
inspire	animar, incitar; animar, incitar
instalment	anualidad
instant	momentito, momento
instantly	directamente, enseguida
instigate	animar, espolear, incitar, inpulsar
instigator	instigador
instinct	instinto
instruct	notificar
instructor	maestro
insulation	aislamiento
insult	injuriar; injuria, insulto, ofensa; insultar, ofender, ultrajar
insurance	seguro
insurance	póliza
insure	asegurar
insurer	asegurador
intend	quererdecir; tenerelpropósito
intense	violento
intensive	violento
intention	intención
inter	enterrar
intercessor	abogado
interchange	cambiar
interest	interesar; interés; interés
interesting	interesante
interference	molestia
interment	enterramiento, entierro; enterramiento, entierro
intermission	descanso
internal	interior, interna
interpreter	interprete
interrupt	interrumpir
intestines	intestinos
intimate	cómodo
into	a, dentrode, en, por
intone	entonar
intoxicate	aturdir
intoxicated	borracho, ebrio
introduce	ofrecer, presentar, reproducir, retratar
invent	inventar; inventar
inverted	conulla
inverted	conullas
invest	colocar
investigation	examen; encuesta
invite	invitar
invite	contratar, daradestajo
invoice	cuenta
invoke	invocar; llamar; invocar; implorar, suplicar
in	activo; activo
in	además; demás, además
in	entodosconceptos
in	precipitadamente
in	comosi
in	contante
in	acomodado
in	entodosconceptos
in	entodosconceptos; entodosconceptos
in	contra
in	enefecto
in	antes, delantede
in	deningunamanera
in	para
in	enprincipio
in	dicho, encuestón
in	alacubana
in	enunprincipio; enunprincipio
in	dedia
in	porlanoche, porlatarde
in	porlamañana
in	atrás, detrás, enpos
in	atiempo
in	envano
in	cómo; como
iodine	yodo
iron	dehierro; hierro; planchar; plancha
ironing	tabladeplanchar
iron	planchar
iron	alambre
irrigate	regar
island	isla
isolation	aislamiento; aislamiento, retiro, separación
issue	darpartede, proclamar, promulgar
itch	picazón
its	su
ivory	marfil
ivy	hiedra, yedra
jack	gato
jacket	americana, chaqueta
jade	cansar, fatigar
jail	prisión; prisión; prisión
jam	mermelada
jaw	mandíbula
jawbone	mandíbula
jeer	injuriar, insultar
jeer	injuriar, insultar
jelly	medusa
jest	bromear
jewel	joya; joya
jeweller	joyero; joyero
job	trabajo; cargo, función, oficio
join	reunirse; juntar, reunir; juntarse; liar, ligar; reunir; juntarse, unirse
joining	unión, reunión
joint	común
joke	bromear; broma, burla, chanza
journalist	periodista; periodista; periodista; periodista
journey	viaje
joy	alegría
joystick	volante
judge	juzgar; juez; criticar, juzgar
judgement	sentencia
judgment	juicio
jug	jarra; jarro, olla; caja, estuche, jarro, olla
juice	jugo, zumo
jump	saltar; salto
junction	unión, reunión
junto	trinquete
just	no...masque, sólo; ahoramismo, enelacto, enseguida, inmediatamente; hacepoco
just	hacepoco
keep	vigilar; conservar, guardar; observar; cometer, hacer, perpetrar; salvar
keeper	archivista, archivero
keepsake	recuerdo; recuerdo
keep	continuar, durar
keep	notocar
key	llave
kick	saquedecomienzo
kick	patada
kidney	riñón
kill	matar
kiln	estufa
kilo	kilo
kilometre	kilómetro
kind	amable, bonito, gracioso; amable; clase, especie, suerte
kindle	encender
king	rey
kingdom	reino
kiss	besar; beso
kitchen	cocina
klaxon	bocina
knapsack	mochila
knee	rodilla
kneel	arrodillarse; arrodillarse; arrodillarse; arrodillarse
knife	cuchillo
knight	caballero
knock	piernastorcidashaciaafuera
knock	llamar
knock	llamaralapuerta
knot	nudo
know	saber
knowledge	conocimiento
know	saber
laborer	obrero, trabajador
labor	bolsadetrabajo
labourer	obrero, trabajador
labour	bolsadetrabajo
lace	encaje
lack	falta
lad	chico, muchacho
ladder	escala
laddie	chico, muchacho
lady	dama
lady	bolsaparaseñoras
laggard	rezagado
laid	encamado
lake	lago
lamb	carnedecordero; cordero
lame	cojo
lamp	lámpara
land	abordar, atracar; país; aterrizar; tierra
landing	amarradero, desembarcadero; desembarcadero; desembarcadero
landing	aterrizaje
landscape	paisaje
landslide	desprendimientodetierras; desprendimientodetierras
lane	calleja
language	lengua
lantern	farol
lapsed	decrépito
large	grande
lark	alondra
lass	muchacha
last	pasada; continuar; continuar, durar; postrero, último; pasada
lasting	continuo; continuo; continuo
last	anoche
late	tardío
lath	tabla
laud	alabar
laugh	reír
laughter	risa
laugh	mofarsede, reírsede
laundry	lavadero
laurel	laurel
lava	lava
law	ley
lawless	desenfrenado, libertino
lawn	batista
lawsuit	proceso
lawyer	abogado
laxative	purgante
lay	aparcamiento
lay	colocar, poner
lay	colocar, meter, poner
lay	buscar, coger, recoger, tomar
lazy	holgazán
lead	guiar; conducir, dirigir; plombo
leader	amo, capitán, caudillo, comandante, dueño, jefe, patrón; guía
leaf	hoja
leaflet	folleto
league	cinta, lazo
lean	apoyarse; fino
leap	añobisiesto
leap	saltar; salto
learn	aprender, estudiar
leather	duro; cuero
leather	artículosdecuero
leave	quitarse, salir; abandonar; dejar
leave	dejar, dejarenpos
leave	desentendersede
leek	ajo
left	porlaizquierda
leg	pierna; pierna
legging	polaina
lemon	limón
lend	prestar
length	largura; largura
lengthen	alargar
lens	lente
lentil	lenteja
less	menos
lesson	lección
less	menosymenos
let	dejar; alquilar; alquilar
letter	carta
letterbox	buzón
lettuce	lechuga
let	informar, divulgar, publicar
level	pasoanivel
level	liso, plano; igual; nivel
lever	levantar
library	biblioteca
licentious	desenfrenado, libertino
lick	lamer
lid	tápa
lie	estartendido; mentir; mentira
lie	acampar
life	vida
lift	levantar; subir; ascensor
light	encender; encender; claro; alumbrar, encender; luz; débil; ligero
lighten	relampaguear
lighter	encendedor, mechero
lighting	alumbrado
lightning	relámpago
like	si; semejante; gustar
likewise	también; idem
like	así
lilac	lila
limb	miembro
lime	tilo
lime	cal
limit	limitar; frontera
limited	limitado
limp	cojear
linden	tilo
line	cordel; línea; turno
lineage	descendencia, origen
lining	forro
lion	león
lip	labio
liqueur	licor
liquid	líquido
liquidate	saldar; matar
liquor	alcohol
list	lista
listen	escuchar
liter	litro
litre	litro
litter	andas, camilla
little	chico, pequeño; poco
little	pocoapoco
live	habitar, morar; vivir
liver	hígado
liver	butifarradehígado
livestock	ganado
load	cargar; carga
loaf	pan
loan	prestar
loathe	detestar
lobster	langosta
location	sitio
loch	lago
lock	esclusa; cerradura; cerrar
locust	saltamontes
lofty	alto
loin	lumbar
long	largo
look	parecer; aspecto, vista; tenga; contemplar, mirar, observar, ver; mirada
looking	espejo
look	vigilar; atendera, cuidarde
look	contemplar, mirar, observar, ver
look	buscar
loose	suelto
lord	caballero, señor
lorry	camión; camión
lose	adelgazar; perder
lose	adelgazar
lose	adelgazar
lose	perderse
loss	perdida
lost	perdido
loud	alto
loudly	enaltavoz
lounge	tresillo
louse	piojo
lovable	afable, amable
love	amar, querer; amor
loved	querido, novio
lovely	agradable; bonito; hermoso, magnífico; caro; bonito, lindo; bonito, encantador, lindo
lover	querido, novio
low	bajo
lower	antebrazo
lower	bajar
low	bajorrelieve
low	bajamar, reflujo
luck	suerte; suerte
luggage	furgón
luggage	equipaje, equipajes
luggage	billetedeequipaje
lukewarm	tibio
lump	bola; pieza; masa; tela, pedazo
lunch	almuerzo; almorzar, comer
lung	pulmón
lupine	loba
luxury	lujo
lynx	lince
lyric	texto
macaroni	macarrones
machine	máquina
mackerel	escombro
madam	señorita
magazine	periódico; revista
magnet	imán
magpie	urraca
maid	criada; criada
mail	correo
mailbox	buzón
main	principal; principal
mainly	sobretodo, principalmente
maintain	conservar, guardar
maintenance	conservación
maize	maíz
major	principal
majority	mayoría
major	carreteraprincipal; carreteraprincipal
make	cometer, fabricar, hacer, perpetrar
make	ofrecer
make	ajustar, contratar, destajar
make	equivocarse
make	apuntar, notar, anotar
make	proyectar
make	limpiar
make	fijar
make	aprovechar; hacerusode, usar
making	confección, fabricación, producción; confección, fabricación, producción; confección, fabricación, producción
male	masculino; masculino
male	cocinero
malicious	astuto
man	hombre; hombre
manage	administrar; administrar; mandar
management	administración; administración
manager	administrador, gerente; gerente; director
manicure	hacerlamanicura
manifacture	confección, fabricación, producción; confección, fabricación, producción
mantle	abrigo
manufacture	fabricar; confección, fabricación, producción
manuring	abono
map	mapa; tarjeta; mapa, plano
marble	mármol
march	andar
margarine	margarina
mark	señal; seña; sellar, timbrar
market	bazar; mercado; mercado, mercadodeconsumo; mercado
marketplace	mercado
mark	amojonar
marmelade	mermelada
marriage	matrimonio; matrimonio; matrimonio
married	casada; casado
marry	casarse; casarse; casarse
marsh	terrenopantanoso
marvel	asombrarse
marvel	asombrarse
mashed	purédepatatas
mass	masa; misa
massage	masajear; amasadura, masaje
massive	maciso
mast	mástil
master	dueño
master	destajista
match	fósforo
material	material; tela
matrimony	matrimonio
matter	asunto, particular; caso; materia
mattress	colchón
mature	maduro
maximum	máximo; máximum
maybe	quizás, talvez
mayhap	quizás, talvez
mayor	alcade; alcade
meager	menesteroso, miserable, necesitado, pobre
meal	harina; comida
mealies	maíz
mean	tenerelpropósito; centro, medio; significar; quererdecir
meaning	intención
means	herramienta, instrumento, medio; medio
measure	medir; medida
measurement	dimensión, tamaño; medida
meat	carne
mechanic	mecánico; mecánico
medicine	medicamento, medicina
meet	quedar; hallar, encontrar; irabuscara
meet	complacer
melon	melón
melt	derretir; derretirse
melting	deshielo
member	partidario; miembro; partidario
memento	recuerdo; recuerdo
memory	recuerdo
menace	amenazar, conminar; amenaza, conminación
mend	remendar
mentally	atrasado
mention	mencionar
menu	tarjeta; lista, menú; lista, menú, plato
merchant	comerciante; comerciante
merciful	misericordioso
mercifulness	misericordia
mercy	misericordia
merit	merecer
message	mensaje, recado; noticia, noticias, publicación
messenger	embajador
metal	metal
metaphor	lenguajefigurado
method	método
methylated	alcoholdequemar
metre	metro
metropolis	capital; capital
midday	mediodía
midday	cena, comida
middle	centro, medio
middy	guardiamarina
midnight	medianoche
midshipsman	guardiamarina
mile	legúa
milk	leche
millimetre	milímetro
milliner	modista
million	millón
minced	carnepicada
mind	observar
mineral	mineral
ministry	ministerio
mint	menta
minute	minuto
minutes	multa, procesoverbal
mirror	espejo
miscarriage	aborto
miscellaneous	todaclasede
mischievous	astuto
miserable	deplorable; malo; afligido, triste; indigente, miserable, pobre; afligido, triste; menesteroso, miserable, necesitado, pobre; indigente, menesteroso, necesitado, pobre
misery	indigencia, pobrezo
miss	perder
mist	niebla
mistake	equivocación, error, yerro
mistaken	malo
mistletoe	muérdago
misty	brumoso
misunderstanding	malentendido
miter	mitra
mitre	mitra
mitten	guante
mixture	mezcla
moan	gemir
mode	moda
modern	moderno
modest	modesto
moist	humedo; humedo
moment	momentito, momento
monastery	convento
money	caja
money	dinero
money	caja
money	giropostal
monk	monje
monkey	llaveinglesa
monkey	mono
monologue	monólogo
monopoly	monopolio
month	mes
monthly	mensualmente
monthly	comadrona
monumental	monumental
mood	humor
moon	luna
moped	ciclomotor, motocicleta
morality	virtud
more	más
moreover	además; demás, además
more	másymás
morning	mañana
mosaic	mosaico
mosaic	mosaico
mosque	mezquita
mosquito	mosquito
most	extremamente
most	principal
motel	motel
mother	madre
motionless	inmóvil
motion	película
motive	lugar, motivo; lugar, motivo; lugar, motivo
motor	lanchamotora
motor	lanchamotora
motor	motor
motorcycle	moto
motorway	autoestrada, autopista, carretera; autovía; autoestrada, autopista, carretera
motor	autoestrada, autopista, carretera; autoestrada, autopista, carretera
mouldy	mohoso
mount	acomodar, adaptar
mountain	montaña, monte
mountaineering	botademontaña
mountain	sierra; cordillera, sierra
mountain	refugio
mountain	pico
mountain	cordillera, sierra
mountain	pico
mourn	deplorar
mouse	ratón
moustache	bigoti
mouth	boca; boca, desembocadura; boca, desembocadura; desembocadura
move	conmover; conmover; moverse
movie	película
movie	cine
moving	conmovedor; conmovedor
much	mucho; mucho
mucus	esputo, flema
mud	barro
mudguard	guardabarros
mulberry	morera
mule	mulo
multiply	multiplicar; multiplicar
murk	tinieblas
muscle	músculo
museum	museo
mushroom	seta; champiñon, hongo, seta
music	música
musician	músico
mussel	almeja
must	tenerque
mustard	mostaza
mute	mudo
mutton	carnero
my	mi
mystify	engañar
myth	mito
mythology	mitología
nail	limaparauñas
nail	lacaparalasuñas
nail	clavo, taco; uña
naked	desnudo
name	nombre
nameless	anónimo
nandu	ñandu
nap	echarlasiesta
napkin	servilleta
narrate	contar
narrow	estrecho
nasty	horrible, lúgubre; feo; horrible, horroroso; malo; deshonesto; astuto
nation	población, pueblo
national	nacional
nationality	nacionalidad
native	innato; indígena; innato
naturally	naturalmente
natural	gasnatural
nature	indole, naturaleza; naturaleza; naturaleza
naughty	muchachotravieso
nausea	aversión, repugnancia
naval	guardiamarina
nave	carretederueda
navigate	navegar
navy	marina
near	miope
near	cercade; entrante, próximo; cerca
nearby	cercade; adyacente, contiguo, vecino; entrante, próximo; cerca
nearly	casi
near	cercade
necessary	necesario
necessity	necesidad
neck	cuello
necktie	corbata
need	necesitar; necesidad; indigencia
needle	aguja; alfiler
needy	indigente, menesteroso, necesitado, pobre
negative	negativo
neglect	descuidar
negligent	descuidado; descuidado
neighbour	vecino
neighbourhood	barrio
neighbouring	adyacente, contiguo, vecino
neither	tampoco; nadie, ninguno
nephew	sobrino
nerve	nervio
net	red
nettle	ortiga
network	red
never	jamás, nunca, no...nunca
new	nuevo
news	noticias
newspaper	periódico
next	después, luego, másadelante; después, luego; entrante, próximo; consecutivo, siguiente, sucesivo; próximo, entrante; entrante, próximo
next	cercade
nice	agradable; amable; bueno; bonito; rico
nickel	níquel
night	camisón
night	noche
nightingale	ruiseñor
nine	nueve
nineteen	diezynueve
nip	aperitivo
no	nadie, ninguno
no	no
nobility	nobleza
nobody	nadie, ninguno
node	nudo
noise	ruido
non	civil
non	antideslizante
non	cadenaantideslizante
none	nadie, ninguno
noon	mediodía
nor	tampoco
normal	normal; normal
north	norte
nose	nariz
nostalgia	nostalgia
not	no
notary	notario
note	billete; anotación; apuntar, notar, anotar; apunte
notebook	carnet, libritodememoria
notepad	blocdenotas; blocdenotas; blocdenotas
nothing	nada
notice	cartel; anuncio; anuncio, aviso; noticia, noticias, publicación
notification	anuncio; anuncio, aviso
notify	anunciar; notificar
notion	inteligencia
not	deningunamanera; deningúnmodo, nimuchomenos, no...deltodo
not	deningunamanera
not	indispuesta
nought	cero
noun	substantivo
nourish	alimentar
nourishment	alimento
novel	nuevo; novela
novelty	noticias
now	actualmente, ahora
nowadays	ahora, alpresente, hoydía
nowhere	enningunaparte
now	decuandoencuando
no	sinduda
no	no...mas, ya...no
nude	desnudo
number	número; número
numberplate	matrícula
numeral	cifra; número
nurse	cuidar; enfermera; comadrona
nut	tuerca; nuez; tuerca
nutmeg	nuezmoscada
nylon	denilón; nilón
n	bata
oak	roble
oar	remo
oasis	oasis
oats	avena
obey	obedecer
object	objecto
objection	objeción
objectionable	censurable, reprobable
obligation	deber
oblique	inclinado
observation	censura, reparo; censura, reparo
observe	observar; cometer, hacer, perpetrar
obstacle	impedimento
obstruct	cercar
obtain	alcanzar, consequir, obtener, procurarse
obtuse	embotado, obtuso
obviously	evidentemente
occasion	lugar, motivo; lugar, motivo
occiput	occipucio
occupation	oficio
occupy	desempeñar, ocupar
occur	acontecer, realizarse, tenerlugar
occurence	acontecimiento
ocean	océano
oculist	oculista
odor	olor
odour	olor
of	de
offence	escandálo
offend	injuriar; insultar, ofender, ultrajar
offer	pretensión; pretensión; ofrecer; oferta, ofrecimiento; ofrecer, presentar, reproducir, retratar; ofrecer, presentar, reproducir, retratar; ofrecer, presentar, reproducir, retratar; proposición; proponer
offer	pretensión
offer	pretensión
office	oficina; cargo, función, oficio
officer	empleado, funcionario
official	oficial; oficial; empleado, funcionario
officially	porrazóndeoficio
offset	distancia
offspring	descendiente
often	amenudo
of	todaclasede
of	hueco
of	demalafama, malreputado
of	noble
oh	ay; ah
oil	aceite
oil	aceitedeoliva
okay	bueno; bien; deacuerdo, enorden, vale, conforme, convenido
okra	ñajú
okra	ñajú
old	anciano, viejo; viejo; viejo
old	derribos
olive	aceitedeoliva
olive	olivo
olive	aceituna
omelette	tortilla
omen	agüero; agüero
omnibus	autobús
omnipotence	omnipotencia
omnipotent	omnipotente, todopoderoso
omniscient	omnisciente
on	adelante; a, dentrode, en, por; pormediode; encuantoa, porlotocantea, respectode; en, sobre
once	unavez
once	denuevo, otravez
one	tráficodedirecciónúnica
one	alguien, alguno, cierto; un, una, uno
onerous	pesado
one	unoymedio
one	ciento
one	paraunapersona
one	mil
one	unavez
onion	cebolla
only	no...masque, sólo; solo, único
only	apenas
on	conmotivode
on	bocaarriba, deespaldas
on	depropósito
on	poreso; poreso
on	alaizquierda
on	atravésde
on	alladerecha
on	arriba
open	abrir; abierto; abierto
open	abrir
opera	ópera
operate	funcionar
operative	obrero, trabajador
ophtalmologist	oculista
opinion	opinión
opium	opio
opportunity	acontecimiento
opposed	contra
opposite	enfrentede; contra; enfrentede
opposite	otrolado
oppress	apretar
oppressive	oprimido
optician	óptico
or	o
orange	naranjo; naranjo
orange	naranja
orange	zumodenaranja
orbit	órbita
order	capitanear; pedir; pedido; encadenación, encadenamiento, orden
ordinary	común
origin	descendencia, origen
original	original; original
originate	descender
ornament	alhaja; decorar; alhaja
orthography	ortografía
ostrich	avestruz
other	otro
other	excepto, menos
ought	tenerque
out	fuera
outer	exterior, externo
outer	neumático
outfit	traje
outing	excursión
outside	fuerade; exterior, externo; fuera
outside	fuerade
outskirts	perímetro
out	de
oven	estufa
over	acabado, terminado; encimade
overall	cabal, completo, entero, todo
overalls	mono
overcoat	abrigo; abrigo
overdrive	cansar, fatigar
overgrown	cubiertodeverdor
overhaul	adelantar; adelantar
overhead	arriba
overlay	forrar, vestir
override	cansar, fatigar
overtake	adelantar; adelantar
overthrow	trastornar
overwhelm	enterrar
over	ahí, allí
ow	ay
owe	deber
owl	buho
own	poseer, tener; propio
owner	dueño, propietario
ownership	propiedad
ox	buey
oyster	ostra
o	hora
pace	paso
pack	empacar, envolver
package	empacar, envolver
packet	paquete
pad	bloque
pail	cubo
pain	dolor
paint	pintura; pintar
painter	pintor
painting	cuadro, pintura
pair	par; par
pair	tenazas
palace	palacio
pale	pálido
palm	palmera
palmtree	palmera
palm	encajar
pamphlet	folleto
pancake	crepe
panties	calzoncillos
pants	pantalón
paper	tapicero
paper	documento; papel; tapizar
paperback	folleto
paperer	tapicero
paprika	pimiento
parade	llamada; llamada
paraffin	petroleo
paragraph	apartado, párrafo
parallel	paralelo
parapet	balaustrada
parcel	paquete
parents	padres, padreymadre
parings	desechos, detrito
park	parque
parking	aparcamiento
parking	aparcamiento; aparcamiento
parking	aparcamiento
parrot	loro
parsley	perejil
part	ingrediente; parte; parte, pieza
partially	enparte
particular	aparte, particular, separado; especial
partition	separación
partly	enparte
partridge	perdiz
party	partido; fiesta; partido; partido
party	partido
pass	adelantar; desfiladero, paso, pasodemontaña; alargar, entregar, llegar, pasar; adelantar; alargar, entregar
passable	practicable, transitable; practicable, transitable
passage	pasillo; paso; paso
passageway	paso
passport	pasaporte
pass	morir
pass	recorrer
past	pasado
paste	masa
pastor	cura; dómine, pastorprotestante; cura
patch	remendar
patch	remendar
pate	cabeza
path	camino, vía; sendero
patience	paciencia
patriarch	patriarca
patron	patrono; protector
pause	descanso
pavement	acera
paw	pierna
pay	pagar, saldar
payment	pago
pay	atender, atendera, tenercuidado
pay	atender, atendera, tenercuidado
pay	amortizar
pay	pagaraplazos
pay	gastar
pay	costear
pea	guisante
peace	paz
peach	melocotón
peak	punta
peanut	cacahué, cacahuete
pear	peral
pear	pera
pearl	perla
pedal	pedal
pedestrian	peatón
peel	cáscara
peel	desconcharse
peg	aperitivo
pelvis	fuente, pelvis
pencil	lápiz
pending	pendiente
peninsula	península
penthouse	cobertizo; cobertizo; cobertizo
penury	indigencia
people	gente; población, pueblo
pepper	pimienta
per	a, dentrode, en, por; por; para
percent	porciento
percentage	porciento
perchance	quizás, talvez
perform	aparecer; entrar, montar; cometer, fabricar, hacer, perpetrar; cometer, hacer, perpetrar; ofrecer, presentar, reproducir, retratar
perfume	perfume
perhaps	quizás, talvez
peril	peligro
period	punto
periodical	periódico; revista; revista
periphery	perímetro
permanent	continuo
permission	declaración; permiso
permit	permitir
persecute	perseguir
person	persona
personal	personal; propio
personality	indole, naturaleza
perspiration	sudor
persuade	convencer
petrol	bencina, gasolina
petroleum	petroleo
petrol	depósitodegasolina
petty	mezquino
pharmaceutical	medicamento, medicina
pheasant	faisán
phenomenal	fenomenal
phlegm	esputo, flema
phone	cabinatelefónica
photograph	foto, fotografía; foto, fotografía
photographer	fotógrafo; fotógrafo
physician	doctor, médico
physics	física
pick	arrancar, cortar; picar
pickle	muchachotravieso
pick	elegir, escoger
pick	buscar, coger, irpor; recoger; buscar, coger, recoger, tomar; irabuscara
picnic	picnic
picture	grabado, imagen, reproducción, retrato; reproducción, retrato; cuadro, pintura
picturesque	pintoresco
picture	postal, tarjetapostal, tarjetapostalilustrada; tarjetapostalilustrada
pie	pastel, torta
piece	pieza; parte, pieza; tela, pedazo
pier	amarradero, desembarcadero; desembarcadero; desembarcadero
pig	cerdo
pigeon	pichón; paloma
piglet	cochinillo, lechón
pike	lucio
pilgrimage	peregrinación, romería
pill	píldora
pillar	columna
pillow	almohada
pin	alfiler
pincers	tenazas; tenazas
pine	pino
pine	pino
pineapple	ananás, piña
pink	clavel; rosado
pinnacle	pico
pioneer	innovador; iniciador
pipe	pipa
piston	pistón
pit	zanja
pitcher	jarra
pitiful	deplorable
pity	compadecera, dolersepor
placard	cartel
place	acomodar, adaptar; sitio; sitio; colocar, meter, poner
place	cuna, patria
place	iglesia
plaice	platija
plain	llano, llanura; claro, evidente
plan	intención; plano, propósito; proyectar; propósito
plane	aeroplano, avión; plano, propósito; cepillo
plank	tabla
plant	cultivar, plantar; planta
planting	cultivo, plantío
plaster	esparadrapo
plastic	plástico
plate	plato; lámina, libra; plato
platform	andén; programa; plataforma
platter	plato
plausible	fidedigno; fidedigno
play	jugar, tocar; jugar; tocar
plaza	plaza
plea	argumento
pleasant	agradable
please	hazfavor, hazelfavor, porfavor; agradar, gustar
pleased	contento
pleasing	agradable
pleasure	agrado, placer; placer
pledge	dinerodelembase
plenty	mucho
plough	arado
pluck	arrancar, cortar
plug	bujía; tampón
plug	comunicar
plum	ciruela
plunge	bucear, zambullirse
poetry	poesía
point	punta; punto
pointed	puntiagudo
point	designar, enseñar, indicar, mostrar
point	resultar
poise	balancear
poison	envenenar; veneno
poisonous	tóxico
pole	bache; poste
pole	podaderademangolargo, podaderadevanilla
police	comisaría
police	policía
policeman	guardia; guardia
policy	póliza; política
polish	cremaparazapatos; limpiar
polite	cortés
politeness	cortesía
politician	político, hombrepolítico
politics	política
pond	estanque
pony	poney
pool	charco; juntarse; piscina; juntarse, unirse
poop	popa; popa
poopdeck	popa; popa
poor	deplorable; malo; indigente, miserable, pobre; pobre
poplar	álamo
population	población
pork	carnedecerdo
port	puerto
portable	portátil
portal	entrada; puerta
portent	agüero; agüero
porter	conserje, portero; mozo
port	babor
pose	darsetono, ponerse, serpresuntuoso
poseur	farsante, presumido
possess	poseer, tener
possible	posible
possibly	quizás, talvez
post	poste; cargo, función, oficio; empleo; correo
postage	franqueo
postage	sello, sellodecorreos
postcard	postal, tarjeta, tarjetapostal
poster	cartel
postman	cartero
postulate	exigir
post	oficinadecorreos
pot	orinal; jarro, olla
potato	patata
potato	fécula, féculadepatata
pottery	cerámica; loza; loza
poultry	aves
pound	libra
pour	derramar
pour	verter
poverty	pobreza
powder	polvos; polvos
practicable	practicable, transitable; practicable, transitable
practice	emplear; ejercicio
practised	experto, hábil
praise	alabar
prawn	gámba
pray	rezar
precipice	abismo, despeñadero, precipicio
precise	preciso
precursor	agüero
predominant	principal
prefer	preferir
preferably	másbien; másbien
pregnant	enestado; enestado
prejudice	prejuicio
premium	prémio
prepare	preparar
presage	agüero; agüero
prescription	receta
presence	presencia
present	actual
present	actual; regalo; contemporáneo; contemporáneo; ofrecer, presentar, reproducir, retratar; ofrecer, presentar, reproducir, retratar; ofrecer, presentar, reproducir, retratar; presente
presentation	oferta, ofrecimiento; oferta, ofrecimiento, presentación
present	ofrecer, presentar, reproducir, retratar
preservation	conservación
preserve	guardar; conservar, guardar
press	apretar
pressing	urgente
pressure	insistencia, instancia; insistencia, instancia; presión
presume	asumir, suponer
presumption	derecho, pretensión
pretence	derecho, pretensión
pretend	fingir; fingir
pretty	amable; majo
prevent	estorbar, impedir; estorbar, impedir
previous	pasada
previously	anteriormente, delante
previous	antesdeque
price	listadeprecios
price	precio
pricey	caro
priest	cura; preste, sacerdote
prince	príncipe
princess	princesa
principal	principal; principal
principally	sobretodo, principalmente
principle	principio
print	imprimir; copiar
prior	pasada
prison	prisión; prisión; prisión
prisoner	detenido
prize	prémio
probably	probablemente
problem	prueba
proceed	continuar
procession	comitiva
proclaim	darpartede, proclamar, promulgar
proclamation	declaración; proclamación
procure	procurarse; procurarse
produce	producir; realizar
product	producto
profess	confesar, declarar
profession	profesión
professional	profesional
profit	provecho; aprovecharse; provecho
profound	profundo
programme	programa
progress	progreso
prohibit	prohibir
project	propósito
promise	prometer; promesa
pronounce	pronunciar; pronunciar
pronunciation	pronunciación
proof	prueba
prop	respaldo
proper	conveniente; preciso
properly	comoesdebido
property	finca, granja; calidad, ralea
proposal	pretensión
prosecute	perseguir
prostitute	prostituta
protect	guardar; defender, guardar, protectar, proteger; guardar
protection	defensa, protección
protect	repeler
protest	protestar; protesta
protocol	multa, procesoverbal
prot	protegido
proud	orgulloso
prove	probar
provided	si
provoke	instigar
provost	alcade
prudish	dengoso, melindroso
pruning	podadera
psalm	salmo
pseudonym	seudónimo
psychiatrist	psiquiatra
pub	taberna; bar
public	plaza
publish	divulgar, publicar
publisher	editor
pudding	pudín
pull	tirar
pull	demoler, derribar
pulverize	moler
pump	daralabomba; bomba
punish	castigar
punishment	castigo
puppet	muñeca
purchase	compra; comprar, procurarse; comprar, procurarse; comprar, procurarse; comprar, procurarse; adquisición, compra; adquisición, compra; adquisición, compra; adquisición, compra; 10.adquisición, compra
purchaser	cliente, comprador
pure	puro
purge	limpiar
purity	limpieza; virtud
purpose	fin, objeto
purse	portamonedas
pursue	perseguir
pus	pus
push	botóndepresión
push	empujar
put	colocar, meter, poner
put	colocar, meter, poner
put	arreglar
put	quitarse
put	arrancar, poner; ponerse
put	darsetono, ponerse, serpresuntuoso
put	ofrecer, presentar, reproducir, retratar
put	apagar
put	contratar, daradestajo
put	acostar
put	acomodar, adaptar
put	tolerar
pyjamas	pijama
quality	calidad, ralea
quantity	cantidad
quarrel	disputar, reñir
quarter	barrio
quash	destruir
quay	andén
queen	reina
quell	sofocar
question	pregunta
quick	rápido
quickly	deprisa, pronto
quicksand	arenasmovedizas; arenasmovedizas
quicksands	arenasmovedizas; arenasmovedizas
quiet	quieto; silencio; calmar, sosegar
quit	darsedebaja, dimitir, hacerdimisión; abandonar
quite	bastante; muy; enteramente
quiver	tremblar
quotation	cita, citación
quotation	conulla
quotation	conullas; conullas
quote	citar, mencionar; conulla
quotes	conullas; conullas
rabbit	conejo
race	correr; raza
radiator	radiador
radio	radio
radish	rábano
radius	radiodeacción
railing	balaustrada
railway	coche
railway	billetedeltren
rain	llover; lluvia
rainbow	arcoiris
raise	entonar; levantar
ram	carnero
ranch	finca, granja
rand	cordillera, sierra; baranda
rank	fila; turno
rapid	rápido
rap	llamaralapuerta
rare	raro
raspberry	frambuesa
rat	rata
rate	fila; estimar
ratepayer	contribuyente
rate	curso
rather	bastante, poco; poco, poquito, tantico; bastante; másbien; bastante
raven	cuervo
ravine	hendidura
raw	crudo; crudo
ray	rayo; raya
razor	hojadeafeitar
reach	alcanzar
react	reaccionar
read	leer
ready	listo
reality	verdad
realization	inteligencia
realize	comprender, entender
really	deveras, enefecto, enrealidad, verdaderamente
rear	luzposterior, luztrasera
rear	luzposterior, luztrasera
rear	retaguardia; revés; retaguardia
rearguard	retaguardia; retaguardia
rear	plataformaposterior
rear	ruedaposterior
reason	causa; lugar, motivo
rebate	bajar; descuento, rebaja, reducción
rebuke	desaprobar, reprobar; censurar, desaprobar, reprender, reprobar; reprender, reprobar
receipt	recibo; recibo, talón
receive	aceptar, admitir, tomar; obtener, recibir
recent	fresco
recently	recientemente
recess	descanso
recipe	receta
recipient	destinatario
recite	recitar
recline	estartendido
recognize	reconocer; reconocer
recollection	recuerdo; recuerdo
recommend	certificar, encarecer, ensalzar, recomender
recommendable	recomendable
recommendation	recomendación
record	certificar, inscribir, registrar; registro; récord
records	archivo
recover	sanar
recruit	alistar; alistar
red	rojo; rojo
redeem	amortizar
redemption	amortización, castigo
reduce	repulsar
red	grosella
red	arenqueahumado
reed	junco
reef	roca
reek	apestar, olermal; oler
refined	fino
reflect	reflexionar
refusal	negativa
refuse	desechos, detrito; rechazar, rehusar
refuse	basurero; basurero
regard	estima, estimación; considerar, contemplar, tomarenconsideración; contemplar, mirar, observar, ver; contemplar, mirar, observar, ver; estima, estimación
region	comarca, región
register	hacerincribir; certificar, inscribir, registrar; registro; certificar, encarecer, ensalzar, recomender
registered	certificado; certificado; certificado
regret	deplorar, sentir; deplorar
regrettable	deplorable
regrettably	esunalástima
regularly	amenudo
regulation	regla
regulations	reglamento
reject	rechazar, rehusar, suspender; rechazar; rechazar, rehusar
relate	contar
relation	relación; conexión, relación
relative	pariente; deudo, familiar, pariente
release	dejar
reliable	deconfianza
religion	religión
relinquish	abandonar, ceder; desistirde, renunciara
remain	quedarseatrás, tardar; quedarse, restar
remainder	desechos, detrito
remark	censura, reparo; censura, reparo
remedy	curar; medio; curar
remit	anular, contramandar
remote	aislado, apartado, separado; lejano
remotely	lejos
remote	telemando
remove	abolir, abrogar
remove	recogerlamesa
rendezvous	cita
renounce	abjurar; desistirde, renunciara
renown	conocimientos; hambre
rent	alquilar
repair	reparar
repayment	anualidad
repeat	repetir; repetir
repentance	arrepentimiento
replace	substituir
replacement	relevo; cumplimiento, relleno, suplemento
replenishment	cumplimiento, relleno, suplemento
reply	contestar, responder; contestación, respuesta
report	informar; comunicar, informar; noticia, noticias, publicación
repose	descansar; descanso
represent	reproducir, retratar; representar
representation	reproducción, retrato
representative	diputado
reproach	censurar, desaprobar, reprender, reprobar; reprender, reprobar
reproof	censura, reparo
reprove	censurar, desaprobar, reprender, reprobar; reprender, reprobar
republic	república
repute	hambre
request	demandar, pedir, solicitar; petición, solicitación, solicitud
require	necesitar; exigir
rescue	salvar
resemble	parecerse
reserve	reservar; pedir; reservar
reservoir	recipientedeagua
residence	domicilio
resign	abdicar; dimitir; darsedebaja, dimitir, hacerdimisión
resist	oponerse, resistir
resources	medio
respect	respetar; estima, estimación
respectable	honorable, respetable
respiration	respiración
respond	reaccionar; contestar, responder
responsibility	responsabilidad
responsible	responsable; responsable
rest	desechos, detrito; descansar; descanso
restaurant	restaurante
restrain	contener, reprimir; capitanear, subyugar; contener, gobernar, subyugar, refrenar, reprimir
restrained	dueñodesímismo
restrict	limitar
restricted	limitado
result	descender; arrojar; resultado
resum	resumen
retain	retener
retardation	retraso
retarded	atrasado
retention	conservación
retreat	retirarse
retrograde	retrógrado
return	billetedeidayvuelta
return	devolver; volver; volver
reveal	divulgar, publicar; revelar
revenge	venganza
reverse	reverso, revés; alcontrario, alrevés; partetrasera, revés
reversed	alcontrario, alrevés
reverse	reverso, revés; partetrasera, revés
revise	revisar
revive	reponerse
revue	revista
reward	recompensar; recompensa
rezignation	resignación
rheumatism	reumatismo
rhino	rinceronte
rhinoceros	rinceronte
rhythm	ritmo
ribbon	cinta
rice	arroz
rickety	decrépito
ride	conducir
ridicule	ridiculizar
ridiculous	ridículo
rifle	escopeta
right	porladerecha; correcto; derecho; preciso
right	ahoramismo, enelacto, enseguida, inmediatamente
right	ahoramismo, enelacto, enseguida, inmediatamente
rigid	rigido
rim	llanta; borde
ring	anillo; llamar, tocarlacampanilla
ring	llamar, tocarlacampanilla
riot	ruido
riotous	desenfrenado, libertino
ripe	maduro
rise	levantarse; subir; levantarse
risk	arriesgar; riesgo
risky	arriesgado
rival	competir; competidor
river	río
road	cascajo
road	camino, vía; camino, vía
roast	asar
roasted	asado
rob	despojar, privar; hurtar, robar
robe	vestido
robust	fuerte, sólido
rock	balancear; roca
rocket	cohete
roe	corzo
roll	llamada; llamada
roll	bocadillo, panecillo; rodar
roller	cilindro
roof	tejado
room	espacio; cuarto, habitación
rooster	gallo
rope	cuerda
rose	rosa
rotten	podrido
rough	crudo; bronco, brusko; áspero, desigual
round	redondo; redondear; alrededorde, entornode
round	redondear
rouse	instigar; espolear; animar, estimular, incitar
route	ruta; camino, vía; ruta
row	barcoderemos
row	remar; turno
rowing	barcoderemos
rub	frotar
rubber	caucho, goma; condom, preservativo; goma
rubbish	desechos, detrito; desechos, detrito; derribos
rubbish	basurero; basurero
rubble	desechos, detrito; cascajo
rudder	timón, volante; timón
rude	descortés, grosero, insolente
rudiments	abecé, alfabeto
ruin	arruinar; ruina
rule	contener, gobernar, subyugar, refrenar, reprimir; regla
rules	reglamento
rum	ron
rumor	hambre
rumour	hambre
run	atropellar; arranque; funcionar; correr; correr
run	acertar
run	huir
rush	apresurarse; apresurarse
rye	centeno
sack	despedir; bolso
sad	afligido, triste; afligido, triste; afligido, triste
sadness	tristeza
safe	seguro
safety	imperdible
safety	seguridad
safety	imperdible
sage	salvia
sailor	marinero
saint	santa; santo
salad	ensalada
salary	salario
sale	consumo, despacho, salida; deducción; venta
salesman	vendedor
saleswoman	dependienta, vendedora
sales	mercado, mercadodeconsumo
sallow	pálido
salmon	salmón
salted	carnesalada
salt	carnesalada
salutation	acogida, saludo
salute	acoger, saludar
sand	arena
sandal	sandalia
sandwich	bocadillo, sandwich
sap	jugo, zumo
satisfied	contento
satisfy	complacer
sauce	salsa
saucepan	cacerola
saucer	platillo
savage	fiero
save	guardar; salvar
saw	sierra
say	decir
say	despedirse
say	despedirse
say	asentir, confirmar
scale	incrustación; escama; ascender, escalar, subira
scales	balanza
scale	desconcharse
scandal	escandálo; escandálo
scarcely	apenas
scare	espantar
scatter	derramar
scenery	paisaje
scent	olor
schedule	horario
scheme	propósito
school	escuela
science	ciencia
scientist	hombredeciencia
scissors	tijeras
scold	exhortar, requerir; censurar, desaprobar, reprender, reprobar; reprender, reprobar
scooter	patinete; patinete
scratch	rascar
scream	gritar
screw	atornillar; tornillo
screwdriver	destornillador
scrupulous	escrupuloso, meticuloso
scuffle	batalla
sculptor	escultor
scythe	guadaña
sea	foca
sea	mar
seagull	gaviota
seal	foca
seam	costura; costura
seaside	costa
season	estación, temporada
seat	asiento, sitio
secede	desertar
second	segundo; segundo
secondhand	desegundamano
second	primosegundo
second	desegundamano
secret	secreto
secretion	secreción
sect	secta
section	departamento, sección
secure	fijar; seguro
security	dinerodelembase; seguridad
see	hallar, encontrar; ver; visitar; cuidar
seek	buscar
seem	parecer
seemly	conveniente
seize	asir, coger
seized	conmovido; conmovido
seizure	apoplejía
seldom	raramente
self	egoísta; egoísta
self	dueñodesímismo
selfish	egoísta; egoísta
selfless	afectuoso; afectuoso
sell	vender
send	despachar, difundir, enviar
sender	remitente; remitente
send	despachar, enviar, expedir
sensation	sentimiento
sense	inteligencia; sentir
sensitive	sensible
sentence	frase; condenar
separate	aparte, particular, separado; apartar, segregar, separar; compartir, dividir
separately	aparte, porseparado
separation	separación; aislamiento, retiro, separación
sepia	calamar
serene	sereno
series	serie
serious	grave, importante; crítico, grave; serio
serpent	serpiente
servant	criada; criado
serve	servir; servir
service	culto, servicio; servicio; servicio
service	servicio
set	aparato; grupo; trinquete; serie
settle	despachar
settlement	colonia
set	acechar
set	acechar
set	estipular
seven	siete
seventeen	diezysiete
seventh	séptimo
several	varios
several	aveces
severe	áspero, inclemente, severo
sew	pegar; coser
sewer	cloaca
sew	pegar
sex	sexo
sexual	sexual
shack	barraca, cobertizo; cabana
shade	sombra
shadow	sombra
shallow	depocaprofundidad, somero
shame	uf; vergüenza
shampoo	champú
shanty	barraca, cobertizo
share	acción; compartir, dividir; parte; parte, pieza; parte, ración; parte
shareholder	accionista
shark	tiburón
sharp	afilado, agudo; afilado, agudo; justamente
shave	afeitar
shaving	brochadeafeitar
shawl	chal
she	osa
she	loba
she	ella
shear	cortar
shed	cobertizo; cobertizo; barraca, cobertizo; cabina, granero, puesto; cobertizo; derramar
sheep	oveja
sheet	hoja; sábana; lámina, libra
sheet	hojalata
shelf	tabla
shell	concha; cáscara
shelter	guardar
sherry	jerez
shifting	llaveinglesa
shine	brillar, lucir
ship	despachar, enviar, expedir; barco, embarcación
shirt	camisa, camiseta
shiver	tremblar
shock	amortiguador
shoe	calzador
shoe	cordón
shoe	calzador
shoe	zapato
shoemaker	zapatero
shoot	tirar
shoot	fusilar
shop	tienda; hacerlascompras
shore	costa
short	miope
short	corto; corto
shortage	falta
shortcoming	falta
shorten	abreviar, acortar
shortness	asma
shorts	pantalóncorto; pantalóncorto
short	cortacircuito
short	pantalóncorto; pantalóncorto
should	tenerque
shoulder	lisera; hombro
shout	gritar; grito
shovel	pala
show	designar, enseñar, indicar, mostrar
shower	ducha
show	escaparate
shrub	arbusto
shut	cerrar; cerrado
shut	parar
siblings	hermanos
side	apéndice
side	carreterasecundaria
side	patillas
side	lado; partido
sideboard	armario
sidewalk	acera
siege	asedio, sitio
sigh	suspirar
sight	aspecto, vista; vista
sightseeing	excursión
sign	agüero; agüero; prueba; señal; seña; firmar
signal	señal; seña
signalman	guardavía
signature	firma
signify	significar
silence	silencio; silencio
silver	plata
similar	semejante
simple	sencillo, simple
since	de, desde; desde; porque, puestoque, yaque
sincere	sincero
sing	cantar
singer	cantora; cantor
single	soltero
sink	bucear
sir	caballero, señor
sister	hermana
sit	estarsentado
sit	sentarse; sentarse
six	seis
sixteen	diezyseis
sixth	sexto
sixty	sesenta
sizable	considerable, notable
size	tamaño
skate	patinar; patinar
skeleton	esqueleto; esqueleto
ski	esquiar; esquí
skilful	experto, hábil
skilfulness	agilidad, destreza
skill	agilidad, destreza
skilled	experto, hábil
skillful	experto, hábil; ágil, experto, diestro, hábil
skillfulness	agilidad, destreza
skim	desnatar
skin	piel; piel
skirt	falda
skull	cráneo
sky	cielo
sky	azul
slab	lámina, libra
slander	calumniar, infamar
slanting	inclinado
slat	tabla
slaughter	matar
slay	matar
sledge	endrino; endrino
sleep	dormir; sueño
sleeping	cama
sleeping	coche?cama
sleeping	cama
sleeve	manga
sleigh	endrino; endrino
slender	fino
slice	filete, tajada, trozo; cortar
slipper	zapatilla
slope	cuesta
slow	lento
slug	babosa
sluice	esclusa
slum	barriobajo
slumber	echarlasiesta
small	mezquino
small	chico, pequeño
smell	apestar, olermal; oler; olor
smell	apestar, olermal
smell	olera
smile	sonreír; sonrisa
smoke	fumar, humear
smoked	ahumado
smokers	departamentodefumar
smooth	liso, plano; liso
snack	almuerzo
snail	caracol; arroba
snake	serpiente
snap	dardentelladasa
snare	astucia
snarl	dardentelladasa
sneeze	estornudar
snifter	aperitivo
snore	roncar
snorter	aperitivo
snow	nevar; nieve
snowflake	copodenieve
snowy	nevado
snub	dardentelladasa
so	paraque; así; así; así
society	club
sock	calcetín
sofa	canapé
soft	dulce; tierno
soil	tierra
soiled	sucio
sole	planta; suela; solo, único; lenguado
sole	representanteexclusivo
solicitor	abogado
solid	fuerte, sólido
soliloquy	monólogo
solitary	solo, único
solve	resolver
somber	afligido, triste
some	bastante, poco; alguien, alguno, cierto; unas, unos
somebody	alguien, alguno, cierto
someone	alguien, alguno, cierto
something	algo
something	noticias
sometimes	aveces
somewhat	bastante, poco
some	alguien, alguno, cierto
son	yerno
son	hijo
song	canción
soon	luego, pronto
soothe	calmar, sosegar
sore	úlcera
sorrow	tristeza
sort	clase, especie, suerte
soul	alma
sound	tocar; ruido, sonido
soup	sopa
sour	agrio; bronco, brusko
source	fuente
south	sur
souvenir	recuerdo; recuerdo
sow	cerda, cochina; sembrar
so	hastaluego, hastalavista
so	asíasí
so	paraque
so	pordecirloasí
spa	aguas, balneario, estaciónbalnearia
space	espacio
spaceman	astronauta
spade	cavar
spanner	llave
spark	chispa; chispa
spark	bujía
sparrow	gorrión
spawn	huevas
speak	hablar
special	aparte, particular, separado; especial
spectacles	gafas
speechless	mudo
speed	prisa; velocidad
speedy	rápido
spell	deletrear
spend	gastar; alargar, entregar, llegar, pasar
spice	especia
spider	araña
spiked	puntiagudo
spinach	espinaca
spine	espinadorsal
spinster	solterona
spirits	alcohol
spit	escupir; escupir
splinter	astilla; astilla
split	fender; henderse, resquebrajarse
spoil	deteriorar; corromper, echaraperder; consentir, mimar
sponge	esponja
spoon	cuchara
sport	deporte
sports	campodeportivo
sports	camisadedeporte
spot	sitio; mancha; punto
spring	fuente; primavera; muelle; saltar
springtime	primavera
spur	espolear
spur	animar, espolear, incitar, inpulsar
square	plaza
square	grupo
squeeze	apretar
squirrel	ardilla
stab	picar
stable	fijo; cuadra, establo
staid	serio
staircase	escalera
stairs	escalera
stake	poste
stale	manido, oprimido; redicho, trillado
stall	cuadra, establo
stallion	caballopadre
stamp	sello, sellodecorreos; sellar, timbrar
stanchion	poste
stand	cabina, granero, puesto; levantarse; estardepie; levantarse
standard	bandera, estandarte
stand	levantarse; levantarse
stand	oponerse
star	estrella
start	arrancar, poner; instigar, maquinar; comenzar, decentar, empezar, enteblar; comenzar, empezar, principiar; comienzo, origen, principio; comienzo, principio; arrancar
starting	puntodepartida, puntoinicial; enlace, puntodecontacto
start	arrancar
state	declarar; estado
statement	declaración
statement	programa
station	estación
stationer	papelería
statue	estatua
stay	alojarse; quedarse, restar
stay	aguardar, esperar
stay	quedarseatrás, tardar
stay	quedarse, restar
stay	alojarse
steak	bife, biftec, bisté, bistec
steal	robar
steamship	barcodevapor
steel	ballena; acero
steep	escarpado
steer	mandar; mandar
steering	volante
stem	tronco; tronco
stench	malolor
stenotypist	mecanógrafa
step	paso
stern	popa; popa; popa
stew	estofadodecarnehúngaro
stewardess	azafata
stick	palo; pegar
stick	quemarse
stiff	rigido
stiffling	oprimido
still	aún, todavia; calmar, sosegar
stimulate	instigar; animar, espolear, incitar, inpulsar; animar, incitar; animar, incitar; espolear; animar, estimular, incitar
sting	picar; aguijón
stink	apestar, olermal
stipulate	estipular
stipulation	condición
stir	conmover
stir	instigar; animar, incitar; espolear; animar, estimular, incitar
stocking	media
stodgy	aburrido; aburrido
stoke	calentar
stomach	estómago
stone	cascajo
stone	piedra
stop	alojarse; parada; parar; parar; parar
storage	acumulador
store	tienda
storey	piso
storm	tempestad, tormenta
story	piso; historia
stove	estufa
straggler	rezagado
straight	derecho
straightforward	sencillo, simple
straight	seguido
straight	seguido
straigh	seguido
strait	estrecho
strawberry	fresa
stray	digresar
stray	extraviarse
stream	corriente; arroyo
strecher	andas, camilla
strech	alargar
street	calle
streetcar	tranvía
strength	fuerza, virtud
stress	acentuar; acento
strict	áspero, inclemente, severo
stride	paso
strike	golpear; llamar; declararseenhuelga; huelga; acertar
string	mondarhabas; cuerda
strip	raya
stripe	raya
stroke	apoplejía; acariciar; caricia
stroke	apoplejía
strong	fuerte
strong	alcohol
struggle	batalla
student	estudiante
study	estudiar; estudio
stun	aturdir
stupefy	aturdir
stupid	zote
sturdy	fuerte, sólido
sturgeon	sollo
sty	cuadra, establo
subject	salvo
subjunctive	modosubjuntivo
subscribe	abonarse, suscribirse
subscriber	abonado, subscriptor, suscriptor
subscribe	abonarse, suscribirse
subscription	abono, subscripción, suscripción; cuota
subsequently	después, luego, másadelante
subside	calmarse, sosegarse
substantive	substantivo
substitute	substituir
substitution	relevo
subtract	sustraer
subway	metro
succeed	conseguir, teneréxito
successor	descendiente
such	tal; así
such	atítulode, como; tal
such	si
suck	chupar
suction	campana
suddenly	degolpe, derepente, desopetón
sue	ponerpleitoa
suffice	bastar
sufficient	bastante
sufficiently	bastante
suffocate	sofocar
sugar	azucarero
sugar	azúcar
sugarbowl	azucarero
suggest	designar, enseñar, indicar
suit	convenir; traje
suitability	capacidad, disposición
suitable	conveniente; conveniente
suitcase	maleta, maletademano
sultry	oprimido
sum	cantidad, importe, suma
summer	verano
summery	resumen
summit	punta; superficie
summon	notificar; llamar
sum	sumar
sun	gafasoscuras
sun	sol
sunrise	salidadelsol
sunset	puestadelsol
superficial	depocaprofundidad, somero
superior	jefe
supermarket	supermercado; supermercado
superscription	título
supersign	acento
supervise	controlar, registrar, revisar
super	autovía
supper	cena
supplement	cumplimiento, relleno, suplemento
supplication	oración, ruego
supply	aprovisionamiento; entregar; aprovisionamiento
support	respaldo; sostener
supporter	partidario; partidario
supporters	partido; partido
suppose	asumir, suponer
supposing	dadoque
suppress	oprimir; sofocar
sure	cierto
surface	superficie
surgeon	cirujano
surly	bronco, brusko
surmise	asumir, suponer
surname	apellido
surpass	aventajar
surprise	sorprender; sorpresa
surrender	capitular
surroundings	alrededores
suspect	sospechar
suspenders	tirantes
suspicion	recelo, sospecha; recelo, recelocaz, sospecha
suspicious	receloso, suspicaz; receloso, suspicaz; receloso, suspicaz
sustain	sostener
sustained	continuo; continuo
swaddling	pañal
swallow	tragar; golondrina
swallow	tomar, tragar
swamp	terrenopantanoso
swap	cambiar
swear	jurar; jurar
swear	abjurar
sweat	sudar, transpirar; sudor
sweep	barrer
sweeper	barrendero
sweet	agridulce
sweet	dulce; dulce
sweetheart	querido, novio
sweet	batata, boniato, camote
swift	rápido
swiftly	deprisa, pronto
swim	nadar
swimming	piscina
swimming	piscina
swimming	bañador
swindle	embuste, engaño
swine	cerdo
swing	balancear
switch	interruptor
switch	parar
switch	arrancar, poner
swoon	desmayarse; desmayo
syrup	almíbar
system	sistema
table	mantel
table	mesa
taco	taco
tail	luzposterior, luztrasera
tail	cola
tailor	costurera; sastre
taint	deterioración, putrefacción
take	aceptar, admitir, tomar; desempeñar, ocupar; buscar, coger, recoger, tomar
take	llevar; irabuscara
take	demontar
take	arrancar, descolgar, quitar
take	ducharse
take	cuidar
take	cuidarsede
take	demoler, derribar
take	aceptar, admitir, tomar; engañar
take	considerar, contemplar, tomarenconsideración
take	despedirse
take	despedirse
take	quitarse
take	comprar, procurarse
take	multar
take	esforzarsepor, tratarde
take	relevar, substituir
taking	adquisición, compra
taking	adquisición, compra
talent	talento; capacidad, disposición, talento
talented	dotado, talentoso; dotado, talentoso; dotado, talentoso
talk	hablar
tall	alto
tame	adiestrar; domesticado, manso
tampon	tampón
tangerine	mandarina
tangle	caos
tank	tanque; tanque
tap	grifo
tape	magnetófono
tapestry	papelpintado
tar	alquitrán
tardy	tardío
target	fin, objeto
tart	agrio; pastel, torta
taste	gusto; saborear
tasty	rico
taunt	injuriar, insultar
tax	imponer; contribución, impuesto, tributo
taxi	taxi
taxpayer	contribuyente
tea	tetera
tea	té
teach	desacostumbrar; enseñar, instruir; enseñar
teacher	maestra; maestro
teapot	tetera
tear	lágrima
tear	arrancar, cortar
technics	técnica
technique	técnica
teetotalism	abstinencia
telegram	telegrama
telephone	teléfono
telephone	cabinatelefónica
telephone	cabinatelefónica
television	televisión
tell	decir; contar
tell	mentir
temper	humor
temperature	temperatura
temple	sien; templo
temporarily	provisionalmente
temptation	tentación
ten	diez
tendency	tentación
tender	dulce; ofrecer, presentar, reproducir, retratar; destajo, subasta; proposición; proponer; oferta, ofrecimiento, proposición
tend	cuidar
tennis	tenis
tension	tensión; afán; voltaje
tent	tiendadecampaña
tented	campamento
terminate	acabar, concluir, terminar; expiración, vencimiento
terms	condición
terrace	terraza
terrain	terreno
terrestrial	terrenal, terrestre; terrestre, terrenal; terrestre, terrenal
test	examen; intentar, probar; carné, carnet
testimony	certificado, certificación
text	texto
than	que
thank	agradecer, dargraciasa
thanks	gracias; gracias
thank	gracias
that	que; cuál, que; así
that	esunalástima
that	asaber, esdecir
that	tal
that	tanto
that	eso
that	así
thaw	deshielo
the	el, la, las, lo, los
theatre	teatro
thee	tutear
theft	robo
their	su
then	después, luego; entonces; entonces
there	tenga; ahí, allí; ahí, allí
thereafter	después, luego
therefore	poreso; poreso
there	hay
there	hay
thermometer	termómetro
thermos	termos
thermos	termos
thermos	termos
these	esta; esta
these	ahora, alpresente, hoydía
they	ellas, ellos; ellas, ellos
the	ExtremoOriente
the	Holanda, LosPaísesBajos
the	mañanapasado, pasadomañana
the	anteayer
thick	grueso
thief	ladrón
thigh	muslo
thin	fino
thing	cosa, objeto; objecto
think	acordarse, creer, pensar; reflexionar
think	reflexionar
think	estimar, respectar
third	tercero; tercio
thirst	sed
thirteen	trece
thirty	treinta
this	esta; esta
thisle	cardo
this	estatarde
this	esta; esta
this	estamañana
those	eso
thou	tú, usted; tú, usted, ustedes, vosotras, vosotros; tú
though	aunque
thought	pensamiento
thoughtful	circunspecto, prudente
thousand	mil
thrash	aporrear, pegar, zurrar
thread	hilo
threat	amenaza, conminación
threaten	amenazar, conminar
three	tresillo
three	tres
three	tresveces
thrice	tresveces
thrifty	económico
throat	garganta
throne	trono
through	acabado, terminado; completamente; pormediode; listo; alolargode, por
throw	echar, lanzar
throw	vomitar
thrust	empujar
thumb	pulgar; pulgar
thunder	tronar; trueno
thus	así; así
thwart	dificultar
ticket	taquilla
ticket	billete; billetedeviaje
tidbit	dulce
tide	marea
tidy	arreglar
tie	corbata; liar, ligar; cinta, lazo
tie	anudar
tie	liar, ligar
tiger	tigre
tighten	apretar
tile	azulejo
till	caja; aque, hastaque
timber	leño, madera
time	horario
time	hora; tiempo
timid	encogido, tímido, miedo
tin	abrelatas
tin	hojalata; lata; estaño
tint	teñir
tin	lata
tin	hojalata
tip	basurero; punta; basurero; propina
tire	neumático
tired	cansado
tired	agotado
tiresome	aburrido
to	a; para
toad	sapo
toast	asar
tobacco	tabaco
today	hoy
toe	dedodepie
together	juntamente
together	asícomo, ytambién; asícomo, ytambien
toilet	papelhigiénico
toilet	excusado, retrete
token	prueba; señal; seña
tolerate	tolerar
tomato	tomate
tomb	tumba
tomorrow	mañana
tomorrow	mañanaporlatarde
tomorrow	mañanaporlamañana
tongs	tenazas
tongue	lengua; lengua
too	también; demasiado
tool	herramienta, instrumento, medio
tooth	cepillodedientes
tooth	pastadentrífica
toothache	dolordemuelas
too	demasiado
top	superficie
topical	actual
total	abstinencia
touch	toque; toque; tocar
touching	conmovedor; conmovedor
touch	tocar
tourist	turista
tourist	agenciadeviaje
tow	remolcar
toward	a
towards	a; alrededorde, entornode
towel	toalla
tower	torre
towing	cablederemolque
town	ayuntamiento
town	ciudad, población
township	pueblecito
town	ayuntamiento
toy	juguete
to	bastante, poco
to	porlaizquierda
to	porladerecha
trace	amojonar; impresión
trace	amojonar
track	impresión
trade	comercio; oficio
traffic	tráfico
trailer	remolque, cocheremolque
train	adiestrar; tren; tren
train	billetedeltren
tram	tranvía
tranquil	sosegado, tranquilo
transfer	atravesar
transitive	activo, transitivo
translate	traducir
transmit	despachar, difundir, enviar
transport	transportar; transporte, trasporte
travel	conducir; viajar
traveller	viajero
travel	agenciadeviaje
tray	bandeja
treat	curar; tratar; tratar
treatment	cura; tratamiento; tratamiento; trato, tratamiento
treaty	tratado
tree	tronco
tree	árbol
tremble	tremblar
tribunal	juzgado
tribute	tributo
trick	malacostumbre, resabio; engañar
trifle	bagatela, friolera
trip	viaje
trite	común, trivial; redicho, trillado
trouble	inconveniente; prueba; incomodar, molestar; molestia
trousers	pantalón
trout	trucha
truck	camión; camión
true	verdadero
truly	deveras, enefecto, enrealidad, verdaderamente
trumpet	trombón
trunk	tronco; baúl, maleta; tronco
trustworthy	deconfianza
truth	verdad
try	intentar, probar
try	probar; probar
tube	cámaradeaire; válvula
tug	tirar
tummy	vientre
tumor	tumor
tumour	tumor
tumult	ruido
tuna	atún
tuna	atún
tune	acomodar, adaptar
tunnel	túnel
tunny	atún
tup	carnero
turkey	pavo
turn	desviarse; talento; trastornar; volver; girar; apretar; turno
turned	piernastorcidashaciaafuera
turnip	apio
turnip	nabo
turnpike	autovía
turn	volver
turn	parar; despachar, despedir, enviar, expedir; apartar, volver
turn	parar
turn	arrancar, poner; poner; apretar
turn	trastornar
turn	volver
turn	aprovechar
twaddle	desatinar
twelve	doce
twenty	veinteyuno
twenty	veinte
twice	dosveces
twin	gemelos
twins	gemelos
two	dos
type	escribiramáquina
typewriter	máquinadeescribir
tyre	neumático; neumático
ugly	feo
ulcer	úlcera
ultimately	alfin, finalmente, porfin
umbrella	paraguas
uncle	tío
unclean	sucio
unconscious	desmayado
uncooked	crudo
uncover	descubrir
under	debajode
undergarment	combinación
underground	metro
underneath	abajo, enelfondo; debajode; abajo
underpants	calzoncillos
understand	comprender, entender
understandable	comprensible, inteligible
understanding	relación; inteligencia
understood	comprendido
undertake	encargarsede, emprender; esforzarsepor, tratarde
undoubtedly	sinduda
undress	bata
unfaithful	renegado
unfortunately	esunalástima; porfortuna; desgraciadamente; desgraciadamente
unhappy	infeliz
unique	único
unite	juntar, reunir; reunir
university	universidad
unkind	bronco, brusko
unknown	desconocido
unlearn	desaprender
unload	descargar
unmarried	soltero
unmarried	solterona
unpleasant	bronco, brusko
unrest	molestia
unroll	devanar; devanar
until	aque, hastaque
untroubled	sereno
unwind	devanar
up	actual
upon	contra; encuantoa, porlotocantea, respectode; en, sobre
upset	indispuesta; trastornar
upstairs	arriba
urban	urbano
urge	animar, espolear, incitar, inpulsar
urgency	insistencia, instancia; insistencia, instancia; prisa
urgent	urgente
urgently	urgentemente
urge	animar, incitar
urinate	mear, orinar; mear, orinar
urine	orina
us	nosotras, nosotros
use	hacerusode, usar; uso
used	usado
use	usar; acabar; acabar; consumir
usual	común; general, universal
uterus	útero
utilize	explotar; aprovechar
vacation	vacaciones
vain	hueco
valiant	bravo
valid	válido
valise	maleta, maletademano
valley	valle
valuable	caro
value	valor
valve	válvula
vampire	vampiro
vanilla	vainilla
vanity	bolsaparaseñoras
variety	cambio, variedad
variety	teatrodevarietés
vary	cambiar, variar
vase	vaso
veal	carnedeternera
vegetable	verduras
vegetarian	vegetariano
vegetation	vegetación
vein	vena
velvet	terciopelo
vend	vender
venereal	enfermedadvenérea
vengeance	venganza
ventilate	ventilar
ventilator	ventilador
venture	arriesgar
verge	lisera
verge	lisera
verify	controlar, registrar, revisar
vermin	insectosdañinos
vermouth	vermut
verse	copla, estrofa
very	muy
very	muy
vessel	caja, estuche, jarro, olla; vaso; barco, embarcación
vest	chaleco
veterinarian	veterinario; veterinario
vicar	cura
vice	alrevés
vice	virtud
vicious	astuto
victory	victoria
view	aspecto, vista; vista; vista; contemplar, mirar, observar, ver; vista
vigour	fuerza, virtud
village	aldea, pueblo
vine	viña; parra
vinegar	vinagre
violate	acometer, asalter
violet	morado
viper	áspid, víbora
visa	visado
visit	visitar; visita
vis	visado
vitamin	vitamina
vocabulary	diccionario
voice	voz
void	vacío
voltage	voltaje
volume	tomo
vomit	vomitar
vote	votar
voting	balotaje
voyage	viaje
wage	salario
wager	apostar
wages	salario
waggon	coche
waist	cintura
waistcoat	chaleco
waistline	cintura
wait	esperar; aguardar, esperar
waiter	camarero
waiting	servicio
waitress	camarera
wait	esperar; aguardar, esperar
waive	desistirde, renunciara
walk	andar
wall	pared; tabique
wallet	cartera; portamonedas
wall	papelpintado
walnut	nogal; nogal
wander	desviarse
wander	digresar
want	necesidad; deseo
wanton	petulante; petulante
wantonness	petulancia; petulancia
war	guerra
wardrobe	armarioropero
ward	repeler
warehouse	almacén
warm	caliente
warn	avisar
warning	aviso
warrant	garantía; orden, ordenporescrito
wash	lavar; lavar
wash	fregar, lavar
wasp	avispa
waste	desechos, detrito; acabar
watch	relojdepulsera; reloj; reloj; contemplar, mirar, observar, ver
watchmaker	relojero
watch	atender, atendera, tenercuidado
watch	vigilar
water	acuarela
water	agua; regar; regar
watercourse	cauce, madre
waterfall	cascada; cascada
wave	ola
waver	titubear, vacilar
wavering	duda, vacilación
wax	cremaparazapatos
way	camino, vía; costumbre; camino, vía
way	salida
we	nosotras, nosotros
weak	débil
weaken	amainar
wealth	riqueza
weapon	arma
wear	llevar; llevar, tenerpuesto
wear	desgastarse
wear	desgastarse
wear	usar; desgastarse
weather	tiempo
wedding	boda; boda
wedding	boda; boda
weekly	semanalmente
weep	llorar
weigh	pesar
weight	peso
welcome	darlabienvenida; bienvenida
well	querido, novio
well	notorio, sabido
well	cortés
well	acomodado
well	bien
wench	muchacha
west	oeste; oeste
wet	mojado
whale	ballena
whalebone	ballena; ballena
wharf	andén
what	atítulode, como
what	esunalástima
what	porqué
what	¿quéhoraes?
wheat	trigo
wheeziness	asma
when	cuando, cuándo; cuando, cuándo; cuando, cuándo; cuando, cuándo
where	donde; donde
which	cuál, que; cuál, que
while	tiempo
whimstone	basalto
whipped	natabatida
whiskers	patillas
whisper	cuchichear
whistle	silbar
white	blanco; blanco
who	cuál, que
whole	cabal, completo, entero, todo
wholly	enteramente
whore	puta
why	porqué; porqué
widower	viudo
width	anchura; anchura
wife	esposa, mujer
wild	fiero
wild	jabalí
will	voluntad
willingly	voluntariamente
willingness	voluntad
willow	sauce
win	ganar
wind	viento
windfall	desechos, detrito
window	ventana; taquilla
wind	devanar
wing	ala
winter	invierno
wipe	enjugar, limpiar
wipe	enjugar, limpiar
wire	alambre; alambre
wireless	radio
wish	desear, querer, tener; deseo; voluntad
with	con; pormediode
within	a, dentrode, en, por; dentrode
without	sin
without	anónimo
without	directamente, enseguida
without	salvo
withstand	oponerse; oponerse, resistir
with	enestado
witness	testigo
woe	ay
wolf	lobo
woman	mujer
womb	útero
wonder	preguntarse; asombrarse
wood	leño, madera
wooden	demadera
woodpecker	pico
woods	bosque
word	palabra
work	funcionar; trabajar; trabajo; obra
worker	obrero, trabajador
working	obrero, trabajador
workman	obrero, trabajador
workplace	taller
work	acabar; calcular, computar
world	mundo
worldglobe	globoterráqueo
worm	gusano
worn	redicho, trillado
worn	gastado, usado
worn	agotado
worry	cuidar
worship	adoración; adorar
worship	culto, servicio
worth	valor
wound	herir; herida
wounded	herido
wrangle	disputar, reñir
wrap	empacar, envolver
wrench	llave
wrest	arrancar
wretched	menesteroso, miserable, necesitado, pobre
wring	arrancar
wrist	relojdepulsera
wrist	muñeca; muñeca
writ	orden, ordenporescrito
write	escribir
writer	autor
write	apuntar, notar, anotar
write	descargar
writing	papeldecartas
wrong	malo
xylophone	xilófono
yacht	yate
yam	batata, boniato, camote; ñame
yard	grave, patio
ye	usted; ustedes
year	año
yearly	anualmente
yellow	amarillo; amarillo
yes	sí
yesterday	ayer
yet	aún, todavia; ya
yield	abandonar, ceder
yoghourt	yogur
yoghurt	yogur
yoke	yugo
yon	ahí, allí
yonder	ahí, allí
you	tú, usted; tú, usted, ustedes, vosotras, vosotros; usted; ustedes
young	joven
youngster	joven
your	tu; tu
youth	juventud; joven
youth	alberguejuvenil
zeal	celo
zero	cero
zinc	zinc
zipper	cremallera
zither	cítara
zone	zona
zoo	jardínzoológico